CCCCCTCTTTT -> CCCCTCTTTTG
ATTAACTCCTC -> TTAACTCCTCA
ACGCGCTGGCC -> CGCGCTGGCCT
AAATGGCAAAT -> AATGGCAAATA
GCATCTACTCT -> CATCTACTCTC
ATGCCTAACTA -> TGCCTAACTAT
GGAACTTAGTA -> GAACTTAGTAC
ACCCCCGACTC -> CCCCCGACTCA
TTACTAATGCG -> TACTAATGCGC
AACAGTCATAG -> ACAGTCATAGA
AGGGGCGCCCC -> GGGGCGCCCCC
TACCCCCGACT -> ACCCCCGACTC
ACCTCCCACAT -> CCTCCCACATC
GAAACTAAATG -> AAACTAAATGG
CCCCGATAACG -> CCCGATAACGT
ACGGCTTCGAC -> CGGCTTCGACG
TATAGTTAGCT -> ATAGTTAGCTA
ATCGAGTAGCT -> TCGAGTAGCTA
TAAGGCCCCTG -> AAGGCCCCTGA
GGTGCGACGCC -> GTGCGACGCCG
ACACGTAGCTG -> CACGTAGCTGT
ATCAAATTACT -> TCAAATTACTT
ACTTGCAATCT -> CTTGCAATCTA
GGGAGCTCCTG -> GGAGCTCCTGA
TAGGATGGAAG -> AGGATGGAAGT
GCGAAGCATTA -> CGAAGCATTAG
TCGACAAGAAA -> CGACAAGAAAA
TAGTGAAATGG -> AGTGAAATGGC
CTCGGGAGCTC -> TCGGGAGCTCC
TTCACCTTCCC -> TCACCTTCCCG
GCCGAGGACAT -> CCGAGGACATT
AGAATGAGAGT -> GAATGAGAGTC
CCTGAGAACCT -> CTGAGAACCTG
GATTGCCTCTC -> ATTGCCTCTCG
TCTGAAAATAC -> CTGAAAATACC
GCTGGCGCTCG -> CTGGCGCTCGT
TTGAAGATTAT -> TGAAGATTATC
TAAACACAGGG -> AAACACAGGGT
GAATAGCCTGA -> AATAGCCTGAG
GCGTCGTACGC -> CGTCGTACGCG
ATGAGAGTCCC -> TGAGAGTCCCA
CACCCGCACCG -> ACCCGCACCGC
GACCAATTTGA -> ACCAATTTGAC
CATAATTAGAG -> ATAATTAGAGA
GTTTGGATTAG -> TTTGGATTAGT
TCTCTCAGCTG -> CTCTCAGCTGG
GGGTCTAACAG -> GGTCTAACAGT
GGGATATGTTA -> GGATATGTTAA
TAACTCCTCAC -> AACTCCTCACT
TCATACTCTTA -> CATACTCTTAT
AACGACGGCAA -> ACGACGGCAAT
ATATACCTCTC -> TATACCTCTCT
CTTATTATGGT -> TTATTATGGTT
GCCTTCGACAC -> CCTTCGACACG
TGTTTACTAAT -> GTTTACTAATG
CAACTTCGTCA -> AACTTCGTCAT
CCTTCCCGCCT -> CTTCCCGCCTT
TACTAATGCGC -> ACTAATGCGCA
GGCAATCGGTG -> GCAATCGGTGT
CAACAATGAAA -> AACAATGAAAA
ACGATCCATAG -> CGATCCATAGC
ATCGGTGTGCA -> TCGGTGTGCAA
CCATAGCTAGG -> CATAGCTAGGT
ACAGACACGAA -> CAGACACGAAA
TATACACGTAG -> ATACACGTAGC
AGCTAGGTGGC -> GCTAGGTGGCG
ACGACGGCAAT -> CGACGGCAATC
TCGAACGACGG -> CGAACGACGGC
CACGGCTTCGA -> ACGGCTTCGAC
TCATACAGAAG -> CATACAGAAGC
AACGTTGCGCC -> ACGTTGCGCCT
CCCCTCTTTTG -> CCCTCTTTTGA
AGCTCCTGATC -> GCTCCTGATCA
TCGGTGTGCAA -> CGGTGTGCAAT
CTTACACTTCG -> TTACACTTCGC
GACTCGAAATT -> ACTCGAAATTA
GCACTGAATTG -> CACTGAATTGC
CTTCGCCATGA -> TTCGCCATGAA
GAGTAACAGTC -> AGTAACAGTCT
ACCTCTCTCTC -> CCTCTCTCTCA
AGCCTGAGAGT -> GCCTGAGAGTT
AGGATAATCAT -> GGATAATCATG
ATGATTAGTCC -> TGATTAGTCCG
CAAGTTTAGTT -> AAGTTTAGTTG
GCGCCAGTCGC -> CGCCAGTCGCC
GGTAGGATAAT -> GTAGGATAATC
AGCCGTTTTCC -> GCCGTTTTCCA
AGGAGTAACAG -> GGAGTAACAGT
GAAATTAACTC -> AAATTAACTCC
GTTAATGGCAT -> TTAATGGCATC
ACGTTGCGCCT -> CGTTGCGCCTT
ATGGAAGTACC -> TGGAAGTACCG
TAAGCCCAGCA -> AAGCCCAGCAC
GGCAAATACCT -> GCAAATACCTC
AAAAGTCTAGC -> AAAGTCTAGCT
CCGTCGGCGTT -> CGTCGGCGTTA
TCAGGGATACA -> CAGGGATACAC
ATCAAGCCGTT -> TCAAGCCGTTT
GACACGAAAGG -> ACACGAAAGGT
CAATGGTCGGT -> AATGGTCGGTC
ACTGAATTGCG -> CTGAATTGCGT
CCCGTCGGCGT -> CCGTCGGCGTT
TCGTGTTAAGA -> CGTGTTAAGAT
TTTAGTCAATG -> TTAGTCAATGG
GTTAAGTCATA -> TTAAGTCATAA
TCGACCAATTT -> CGACCAATTTG
GCAGCGACGTC -> CAGCGACGTCT
TAACGTTGCGC -> AACGTTGCGCC
GGAGTAACAGT -> GAGTAACAGTC
TTTATTGGTCT -> TTATTGGTCTC
GTCCTGCTTCA -> TCCTGCTTCAA
TCATGAACGAA -> CATGAACGAAA
CTTTTGAAACT -> TTTTGAAACTA
GGGGTGTCGTG -> GGGTGTCGTGT
GGCGCTCGTTT -> GCGCTCGTTTA
GAGAGTTCTGC -> AGAGTTCTGCA
GTTAAGGCCCC -> TTAAGGCCCCT
GAGTAACCAAA -> AGTAACCAAAG
ATCAATACGGC -> TCAATACGGCG
GGAGCCATCAA -> GAGCCATCAAG
CGCGTAGTAAT -> GCGTAGTAATA
GGCCATCAATA -> GCCATCAATAC
CCGGGTTCTAC -> CGGGTTCTACG
AACCCACGCAA -> ACCCACGCAAA
GGTACCTCCCA -> GTACCTCCCAC
ACGTGGTTAAT -> CGTGGTTAATG
TCGCGGTCTAC -> CGCGGTCTACA
TACTTTTTACC -> ACTTTTTACCG
TTAAGAAAGAA -> TAAGAAAGAAT
ATCCATTCACC -> TCCATTCACCT
TTTAAACACAG -> TTAAACACAGG
TAGCTAGTCGC -> AGCTAGTCGCT
CATACGTGGTT -> ATACGTGGTTA
AACCTGCGGCG -> ACCTGCGGCGA
GAGTTCAACAA -> AGTTCAACAAT
AGGTCACCAAC -> GGTCACCAACA
TGGCATGGGTT -> GGCATGGGTTG
AGCTAGGAGGG -> GCTAGGAGGGA
ATGAAAAAGTC -> TGAAAAAGTCT
CGATCAAATTA -> GATCAAATTAC
TCTCAATCATG -> CTCAATCATGA
TATTCGTTCGG -> ATTCGTTCGGC
TTATTGGTCTC -> TATTGGTCTCT
ACTGAATCCGC -> CTGAATCCGCG
AAAAAGTCTAG -> AAAAGTCTAGC
AAACGTCTATT -> AACGTCTATTC
TGGGTCGACAA -> GGGTCGACAAG
ATGGCATCTAC -> TGGCATCTACT
ATGTGGTGAAG -> TGTGGTGAAGA
CTCTTATTATG -> TCTTATTATGG
AAGTCAGCAAA -> AGTCAGCAAAA
TCTTGGCAGCG -> CTTGGCAGCGA
AAGCCCAGCAC -> AGCCCAGCACA
GCGAATACCCA -> CGAATACCCAG
CCAGCACATAC -> CAGCACATACG
GACACGATTCG -> ACACGATTCGC
CATCGAACGCC -> ATCGAACGCCC
GTGATGGAACT -> TGATGGAACTT
CCTTATATACC -> CTTATATACCT
TCCCCGTGTTT -> CCCCGTGTTTG
TTAGTTGAAGA -> TAGTTGAAGAT
GAAGTACCGGG -> AAGTACCGGGT
TAGCTTGGCAT -> AGCTTGGCATG
TCCATTCACCT -> CCATTCACCTT
CCGCACCGCAG -> CGCACCGCAGT
AGTACCGGGTT -> GTACCGGGTTC
CTCTCGGGAGC -> TCTCGGGAGCT
GCTGGCCTTAC -> CTGGCCTTACA
ACAAGCAGCAA -> CAAGCAGCAAC
TCACTGACCTA -> CACTGACCTAC
CGCCAGTCGCC -> GCCAGTCGCCA
CCTCTCTCTCA -> CTCTCTCTCAA
TCACCTTCCCG -> CACCTTCCCGC
CACAATATCCA -> ACAATATCCAT
ATAATTAGAGA -> TAATTAGAGAT
AATAAATCGAG -> ATAAATCGAGT
TCGAACCCACG -> CGAACCCACGC
CAAGCAGCAAC -> AAGCAGCAACA
CCGCAGTTTGA -> CGCAGTTTGAG
AGTTAGCTAGT -> GTTAGCTAGTC
ACACTTCGCCA -> CACTTCGCCAT
GGGCTCAGGGA -> GGCTCAGGGAT
GAACCTGTTGT -> AACCTGTTGTC
TGTGGTGAAGA -> GTGGTGAAGAG
GTAGTGCCGAG -> TAGTGCCGAGG
CTACAGACACG -> TACAGACACGA
GGGTACCTCCC -> GGTACCTCCCA
CGTGGTTAATG -> GTGGTTAATGG
CACTGAATTGC -> ACTGAATTGCG
TTGAGTATACA -> TGAGTATACAC
CTCTCAATCAT -> TCTCAATCATG
TCTACTCTCGG -> CTACTCTCGGG
AAAGTCTAGCT -> AAGTCTAGCTT
CCTACAGACAC -> CTACAGACACG
CGAACGCCCGA -> GAACGCCCGAT
TCGCCTTATAT -> CGCCTTATATA
GGTCGGTCCTT -> GTCGGTCCTTT
CAGCTGGCGCT -> AGCTGGCGCTC
GTAGGATAATC -> TAGGATAATCA
GGCTTCGCTTC -> GCTTCGCTTCT
ATAAGCCCAGC -> TAAGCCCAGCA
TCACAATATCC -> CACAATATCCA
ATCATGTGGTG -> TCATGTGGTGA
CTCGAAATTAA -> TCGAAATTAAG
ATTAAGGAAAG -> TTAAGGAAAGT
TTACGGCTCTT -> TACGGCTCTTG
GGCTAATAGTG -> GCTAATAGTGA
GGACTCGAAAT -> GACTCGAAATT
TTCCACCACGT -> TCCACCACGTC
CGAAGCATTAG -> GAAGCATTAGC
ATGGTCACAAT -> TGGTCACAATA
CGAACATAAAT -> GAACATAAATG
CCACGCAAAGA -> CACGCAAAGAC
CTGTTGTCATT -> TGTTGTCATTA
CCGCGACCCGT -> CGCGACCCGTA
CACAAGCAGCA -> ACAAGCAGCAA
CCTCTCGCCTC -> CTCTCGCCTCA
TGAAGATTATC -> GAAGATTATCA
TAGGGGCGCCC -> AGGGGCGCCCC
TGGTCTCTGCG -> GGTCTCTGCGG
CAGCACATACG -> AGCACATACGT
TCTTATTATGG -> CTTATTATGGT
GCCTCTTTATT -> CCTCTTTATTG
GGGTTCTACGG -> GGTTCTACGGC
TCTACCCCCGA -> CTACCCCCGAC
TAGGAGGGAGC -> AGGAGGGAGCA
AAATACCTCAA -> AATACCTCAAG
CGTTTAATTAT -> GTTTAATTATA
ATGGGTTGCTC -> TGGGTTGCTCG
GTTGCTCGGTT -> TTGCTCGGTTA
ATAGAGGCCTC -> TAGAGGCCTCT
AAAAGGCAGAG -> AAAGGCAGAGG
TACCCAGCGGA -> ACCCAGCGGAC
TACTCTCGGGA -> ACTCTCGGGAG
TATTATGGTTT -> ATTATGGTTTA
TTAATGGCATC -> TAATGGCATCT
AGCGACGTCTG -> GCGACGTCTGA
CGTCGTTAAGG -> GTCGTTAAGGC
TTAACTCCTCA -> TAACTCCTCAC
TAAAAGGCAGA -> AAAAGGCAGAG
TCGGTTAATCA -> CGGTTAATCAA
TGGCCTTACAC -> GGCCTTACACT
CATGGGTCGAC -> ATGGGTCGACA
GTTTACTAATG -> TTTACTAATGC
TTTGGATTAGT -> TTGGATTAGTT
TCTAGGATGGA -> CTAGGATGGAA
TCAGCTGGCGC -> CAGCTGGCGCT
GCGCGATAAGC -> CGCGATAAGCC
ACCTGTTGTCA -> CCTGTTGTCAT
CGCAAAGACTG -> GCAAAGACTGG
TAACAGTCTAG -> AACAGTCTAGC
ATAACCGGATC -> TAACCGGATCA
GGGTGATGGAA -> GGTGATGGAAC
TTGGCAGCGAC -> TGGCAGCGACG
GCCCAGCACAT -> CCCAGCACATA
ATACGGCGTCG -> TACGGCGTCGT
TGGCAGCGACG -> GGCAGCGACGT
TGCCTCTCGCC -> GCCTCTCGCCT
CCCGACTCACT -> CCGACTCACTG
TGATTAGTCCG -> GATTAGTCCGC
AGTATACACGT -> GTATACACGTA
AACAGGTTAAG -> ACAGGTTAAGT
AATCCGCGGGA -> ATCCGCGGGAT
TCGGCGTTAAC -> CGGCGTTAACA
GAATCCGCGGG -> AATCCGCGGGA
CAATCAGATGG -> AATCAGATGGT
GAATACCCAGC -> AATACCCAGCG
ATCGAACGCCC -> TCGAACGCCCG
GGGGAGCCATC -> GGGAGCCATCA
ATCCCCGTGTT -> TCCCCGTGTTT
GCTAGTCGCTA -> CTAGTCGCTAA
TAGTCCGCGCG -> AGTCCGCGCGT
AAGAGTTGAAG -> AGAGTTGAAGA
TTGGCATGGGT -> TGGCATGGGTT
ATTTAGTCAAT -> TTTAGTCAATG
CATACTCTTAT -> ATACTCTTATT
CAGGTCACCAA -> AGGTCACCAAC
GGCAGAGGTTA -> GCAGAGGTTAC
GATGGTCACAA -> ATGGTCACAAT
TCGCCTCATAC -> CGCCTCATACA
TCCTTGATGCC -> CCTTGATGCCT
TGGTTTAAACA -> GGTTTAAACAC
GGTTAATCAAG -> GTTAATCAAGC
CGACCAATTTG -> GACCAATTTGA
GAAGATTGCCT -> AAGATTGCCTC
AGCTAACCTAT -> GCTAACCTATA
CCAATTTGACT -> CAATTTGACTG
GGTCGAACGAC -> GTCGAACGACG
TCTGTACTAGG -> CTGTACTAGGG
GAGTATACACG -> AGTATACACGT
TCGTTTAATTA -> CGTTTAATTAT
GTCGTACGCGA -> TCGTACGCGAA
CGTATAGGGGT -> GTATAGGGGTG
TCATAGAGGCC -> CATAGAGGCCT
AGGTGGCGCGA -> GGTGGCGCGAT
CCTCAAGTCGC -> CTCAAGTCGCG
TACGGCTTCGC -> ACGGCTTCGCT
GTCTACCCCCG -> TCTACCCCCGA
TGAGAGTCCCA -> GAGAGTCCCAC
GATTAGTTAAG -> ATTAGTTAAGA
ATGAAGCAGGT -> TGAAGCAGGTC
CGAATACCCAG -> GAATACCCAGC
AGCGGACTCGA -> GCGGACTCGAA
TAGCCTGAGAG -> AGCCTGAGAGT
TTTGGCTAATA -> TTGGCTAATAG
ATTGCCTCTCG -> TTGCCTCTCGC
GCAAAAATCGA -> CAAAAATCGAA
AGATTGCCTCT -> GATTGCCTCTC
TTGCGGCCGGC -> TGCGGCCGGCC
GGGGTCTAACA -> GGGTCTAACAG
AATCGGTGTGC -> ATCGGTGTGCA
TCCGCGGGATA -> CCGCGGGATAT
TAATGAAGCAG -> AATGAAGCAGG
GTAATAGCTGA -> TAATAGCTGAA
GCCCCTGAGAA -> CCCCTGAGAAC
TTATTATGGTT -> TATTATGGTTT
CTCGTTTAATT -> TCGTTTAATTA
GTTAATCAAGC -> TTAATCAAGCC
AGGATGGAAGT -> GGATGGAAGTA
CCGGAAGAAGA -> CGGAAGAAGAA
ATTAGCAGCTA -> TTAGCAGCTAA
ACTCTCGGGAG -> CTCTCGGGAGC
TCGCACTGAAT -> CGCACTGAATT
ACTCACTGACC -> CTCACTGACCT
GTACCTCCCAC -> TACCTCCCACA
TTAAGGCCCCT -> TAAGGCCCCTG
TCATGTGGTGA -> CATGTGGTGAA
AAAGAATGAGA -> AAGAATGAGAG
AATTATAGTAC -> ATTATAGTACC
CGTGTTTGGCT -> GTGTTTGGCTA
GCGGACTCGAA -> CGGACTCGAAA
TAACACTTGCA -> AACACTTGCAA
CGCGCGTAGTA -> GCGCGTAGTAA
GCGAATAGCCT -> CGAATAGCCTG
AGCTGAGCGAA -> GCTGAGCGAAC
AGTCTTTGTTC -> GTCTTTGTTCG
TCCTGGACGGT -> CCTGGACGGTT
AATGAGAGTCC -> ATGAGAGTCCC
TGGCAAATACC -> GGCAAATACCT
ACAGTCTAGCT -> CAGTCTAGCTG
TCTGCATGGGT -> CTGCATGGGTC
CGTCCTGCTTC -> GTCCTGCTTCA
ACAATATCCAT -> CAATATCCATT
TACAGAAGCAA -> ACAGAAGCAAA
TACAACTTCGT -> ACAACTTCGTC
GGTTTAAACAC -> GTTTAAACACA
GCACATACGTG -> CACATACGTGG
CCAGCCTCTGT -> CAGCCTCTGTA
AATGGTTACGG -> ATGGTTACGGC
GGGCGCCCCCT -> GGCGCCCCCTC
TAATAAATCGA -> AATAAATCGAG
AATACCCAGCG -> ATACCCAGCGG
TTGCAATCTAG -> TGCAATCTAGG
TTGGTCTCTGC -> TGGTCTCTGCG
AACCGGATCAA -> ACCGGATCAAG
TATCACTCCCC -> ATCACTCCCCT
AAGACTGGGGT -> AGACTGGGGTC
CTAATAGTGAA -> TAATAGTGAAA
TCAAGCTAATA -> CAAGCTAATAA
ACGCTGACGTG -> CGCTGACGTGA
GTTACGGCTCT -> TTACGGCTCTT
TGTACTAGGGG -> GTACTAGGGGT
TCGACGCTGAC -> CGACGCTGACG
GTCGACAAGAA -> TCGACAAGAAA
GCCGATCCAGG -> CCGATCCAGGT
GCTCAGGGATA -> CTCAGGGATAC
CACGCAAAGAC -> ACGCAAAGACT
CCTCTTTATTG -> CTCTTTATTGG
GCGTTAACACT -> CGTTAACACTT
CGCGCTGGCCT -> GCGCTGGCCTT
TACTCTTATTA -> ACTCTTATTAT
GGGATACACGG -> GGATACACGGC
AGGTGCCTGTT -> GGTGCCTGTTG
ATACCAGTGTA -> TACCAGTGTAG
AAGGGTACCTC -> AGGGTACCTCC
AGTCCCACCCG -> GTCCCACCCGC
AAGCAGCAACA -> AGCAGCAACAG
AAGGGGTAGGA -> AGGGGTAGGAG
ATGTTTACTAA -> TGTTTACTAAT
AAATTAACTCC -> AATTAACTCCT
ATGTTAAGAGT -> TGTTAAGAGTT
GCGATAAGCCC -> CGATAAGCCCA
ATACTCTTATT -> TACTCTTATTA
AAGGCCCCCGG -> AGGCCCCCGGA
TGGAAGTACCG -> GGAAGTACCGG
CTACGGCTTCG -> TACGGCTTCGC
CCAGTGTAGTT -> CAGTGTAGTTT
GCCTTAGGGGC -> CCTTAGGGGCG
ACGGCTCTTGG -> CGGCTCTTGGC
GGAAAGTCAGC -> GAAAGTCAGCA
AGTGTAGTTTT -> GTGTAGTTTTT
ACCAACACATA -> CCAACACATAA
TGACCTACAGA -> GACCTACAGAC
AATTAGAGATT -> ATTAGAGATTC
ACTGACCTACA -> CTGACCTACAG
AAAGACTGGGG -> AAGACTGGGGT
ATACCTCTCTC -> TACCTCTCTCT
TTCCTTGATGC -> TCCTTGATGCC
GGTGTCGTGTT -> GTGTCGTGTTA
CAAAAGGCCCC -> AAAAGGCCCCC
CGACGTCTGAC -> GACGTCTGACG
CGCCCCCTCTT -> GCCCCCTCTTT
GTCTAGCTGAG -> TCTAGCTGAGC
TCAGCGCCAGT -> CAGCGCCAGTC
GTTAGCTAGTC -> TTAGCTAGTCG
ACATAACCGGA -> CATAACCGGAT
TGTTGCGGCCG -> GTTGCGGCCGG
CTGGACGGTTT -> TGGACGGTTTG
AAAAATCGAAC -> AAAATCGAACC
CAGCGGACTCG -> AGCGGACTCGA
TTGTCATTACT -> TGTCATTACTG
GTACGCGCTGG -> TACGCGCTGGC
TCAAGCCGTTT -> CAAGCCGTTTT
TTAGAGATTCA -> TAGAGATTCAG
AACCTGTTGTC -> ACCTGTTGTCA
GCTAGGTGGCG -> CTAGGTGGCGC
TCGAGTAGCTA -> CGAGTAGCTAG
ACCCAGCGGAC -> CCCAGCGGACT
GACGCCGATCC -> ACGCCGATCCA
AACACTTGCAA -> ACACTTGCAAT
GATTCAGCGCC -> ATTCAGCGCCA
CGACTCACTGA -> GACTCACTGAC
AGGAGGGAGCA -> GGAGGGAGCAC
ACGGCAATCGG -> CGGCAATCGGT
CGGTCCTTTCT -> GGTCCTTTCTC
ACTATAGTTAG -> CTATAGTTAGC
GTCGCGGTCTA -> TCGCGGTCTAC
GAGGCCTCTTT -> AGGCCTCTTTA
CCCAGCGGACT -> CCAGCGGACTC
CTAATGAAGCA -> TAATGAAGCAG
CCTTCGACACG -> CTTCGACACGA
AACACATAACC -> ACACATAACCG
CTGAGAGTTCT -> TGAGAGTTCTG
TGGGTCCTGGA -> GGGTCCTGGAC
GCCCCCGGAAG -> CCCCCGGAAGA
AGTCTAGCTTG -> GTCTAGCTTGG
CGTAGCTGTAG -> GTAGCTGTAGT
GCGTCCTGCTT -> CGTCCTGCTTC
ACGATTCGCCT -> CGATTCGCCTT
GCCTTATATAC -> CCTTATATACC
TCAGATGGTCA -> CAGATGGTCAC
CAGCTAACCTA -> AGCTAACCTAT
ACCAAAGGAAT -> CCAAAGGAATT
TCAAATTACTT -> CAAATTACTTT
GCAAATACCTC -> CAAATACCTCA
TCCCGCCTTCG -> CCCGCCTTCGA
AGGAATTATTC -> GGAATTATTCG
TAGTCGCTAAA -> AGTCGCTAAAA
CGCTCGTTTAA -> GCTCGTTTAAT
ACATCGAACGC -> CATCGAACGCC
GCTCCTGATCA -> CTCCTGATCAT
GTTGCGGCCGG -> TTGCGGCCGGC
GCAAAGACTGG -> CAAAGACTGGG
ATAAATGTTTA -> TAAATGTTTAC
AGTTAAGAAAG -> GTTAAGAAAGA
CATCTGAAAAT -> ATCTGAAAATA
CTCCCCGATAA -> TCCCCGATAAC
TTATATACCTC -> TATATACCTCT
GACTGGGGTCT -> ACTGGGGTCTA
TGTAGTGCCGA -> GTAGTGCCGAG
AGCTAGTCGCT -> GCTAGTCGCTA
AAGAGCAAGGC -> AGAGCAAGGCT
TGTCATTACTG -> GTCATTACTGG
AAATACCAGTG -> AATACCAGTGT
AGTTCTGCATG -> GTTCTGCATGG
CGTTGCGCCTT -> GTTGCGCCTTA
TTGAAGATTGC -> TGAAGATTGCC
TTAAGATCCCC -> TAAGATCCCCG
GGATACACGGC -> GATACACGGCT
ACGTAGCTGTA -> CGTAGCTGTAG
CAGGGATACAC -> AGGGATACACG
CTAACAGTCAT -> TAACAGTCATA
TTCTACGGCTT -> TCTACGGCTTC
GAGGTTACGTC -> AGGTTACGTCG
GTCGTGTTAAG -> TCGTGTTAAGA
TCGCTTCTTCG -> CGCTTCTTCGG
CCGATCAAATT -> CGATCAAATTA
CCACCCGCACC -> CACCCGCACCG
AGTAACCAAAG -> GTAACCAAAGG
ACACATAACCG -> CACATAACCGG
TTACCGCGACC -> TACCGCGACCC
CGGGCTCAGGG -> GGGCTCAGGGA
ACCGGGTTCTA -> CCGGGTTCTAC
GCGCTGGCCTT -> CGCTGGCCTTA
AACCAAAGGAA -> ACCAAAGGAAT
CATTACTGGGT -> ATTACTGGGTC
TAGCTGTAGTG -> AGCTGTAGTGC
CCGGCCATCAA -> CGGCCATCAAT
AAATGTTTACT -> AATGTTTACTA
AGGGGTGTCGT -> GGGGTGTCGTG
CCCGTGTTTGG -> CCGTGTTTGGC
AATCATGTGGT -> ATCATGTGGTG
CCCGCACCGCA -> CCGCACCGCAG
ACGCCGATCCA -> CGCCGATCCAG
CCATGAAAACC -> CATGAAAACCA
CTCTCAGCTGG -> TCTCAGCTGGC
CAGCAAAAGGC -> AGCAAAAGGCC
CAGGGTGATGG -> AGGGTGATGGA
TTCGGGCTCAG -> TCGGGCTCAGG
CTAGGGGTGCG -> TAGGGGTGCGA
ATGGTTACGGC -> TGGTTACGGCT
CGTCTATTCGC -> GTCTATTCGCA
CCCTGAGAACC -> CCTGAGAACCT
ATTGGTCTCTG -> TTGGTCTCTGC
AGAACGGACTA -> GAACGGACTAT
CGGCTTCGCTT -> GGCTTCGCTTC
GATCCATAGCT -> ATCCATAGCTA
ACCGCAGTTTG -> CCGCAGTTTGA
TCACAAGCAGC -> CACAAGCAGCA
TGGCATCTACT -> GGCATCTACTC
CGAATAGCCTG -> GAATAGCCTGA
CCCCGACTCAC -> CCCGACTCACT
CCGTGTTTGGC -> CGTGTTTGGCT
GCCTCATACAG -> CCTCATACAGA
AAAGGCCCCCG -> AAGGCCCCCGG
ATACCCAGCGG -> TACCCAGCGGA
GATGGAAGTAC -> ATGGAAGTACC
AAGAAGAATTT -> AGAAGAATTTA
GATCAAATTAC -> ATCAAATTACT
TAATAGCTGAA -> AATAGCTGAAA
TACCAGTGTAG -> ACCAGTGTAGT
AATGAAAAAGT -> ATGAAAAAGTC
GCGCCCCCTCT -> CGCCCCCTCTT
AGTTTTTGAGT -> GTTTTTGAGTA
AATATCCATTC -> ATATCCATTCA
GCAACAGGTTA -> CAACAGGTTAA
GTAGGAGTAAC -> TAGGAGTAACA
CAGTGTAGTTT -> AGTGTAGTTTT
GTTTAGTTGAA -> TTTAGTTGAAG
GTTAAGAGTTG -> TTAAGAGTTGA
GTCGCTAAAAG -> TCGCTAAAAGG
CGCACTGAATT -> GCACTGAATTG
AAGAAAGAATG -> AGAAAGAATGA
AACGGACTATT -> ACGGACTATTG
CTGAATTGCGT -> TGAATTGCGTC
ACTTCGTCATC -> CTTCGTCATCA
CGCTGACGTGA -> GCTGACGTGAG
ATTATCACTCC -> TTATCACTCCC
TGACGATCCAT -> GACGATCCATA
ATACGTGGTTA -> TACGTGGTTAA
GGCTCTTGGCA -> GCTCTTGGCAG
CCAGTCTACCC -> CAGTCTACCCC
ACGAAATTAAC -> CGAAATTAACT
ACCCACGCAAA -> CCCACGCAAAG
GAATTATTCGT -> AATTATTCGTT
GGCCGGCCATC -> GCCGGCCATCA
ACTCTTATTAT -> CTCTTATTATG
GAAGAATTTAG -> AAGAATTTAGT
CGGCGAAGCAT -> GGCGAAGCATT
AATTACTTTTT -> ATTACTTTTTA
CTTGGCAGCGA -> TTGGCAGCGAC
TTAAGTCATAA -> TAAGTCATAAT
GTGGTGAAGAG -> TGGTGAAGAGC
GACAAGAAAAG -> ACAAGAAAAGA
AAGGCAGAGGT -> AGGCAGAGGTT
GAACATAAATG -> AACATAAATGT
ACTATTGTTAA -> CTATTGTTAAG
TTCGCCTTATA -> TCGCCTTATAT
TGCAATCTAGG -> GCAATCTAGGA
GTTAAGGGTAC -> TTAAGGGTACC
AGCACATACGT -> GCACATACGTG
GAAGCATTAGC -> AAGCATTAGCA
GTTGTCATTAC -> TTGTCATTACT
GTGAAATGGCA -> TGAAATGGCAA
TGCCGAGGACA -> GCCGAGGACAT
TCTGACGATCC -> CTGACGATCCA
ATTTGACTGAA -> TTTGACTGAAT
CTTCCCGCCTT -> TTCCCGCCTTC
CAACACATAAC -> AACACATAACC
CTAATAAATCG -> TAATAAATCGA
TCGCCATGAAA -> CGCCATGAAAA
TAATTATAGTA -> AATTATAGTAC
TAGGTGGCGCG -> AGGTGGCGCGA
CCGCCTTCGAC -> CGCCTTCGACA
ACCCGTATAGG -> CCCGTATAGGG
AGAGCAAGGCT -> GAGCAAGGCTC
TATAGTACCCG -> ATAGTACCCGT
AACATAAATGT -> ACATAAATGTT
CGAAATTAACT -> GAAATTAACTC
ACAATGAAAAA -> CAATGAAAAAG
ATATCCATTCA -> TATCCATTCAC
GTCCTGGACGG -> TCCTGGACGGT
TGTTAAGATCC -> GTTAAGATCCC
TCGGGAGCTCC -> CGGGAGCTCCT
ATGCGCATAAG -> TGCGCATAAGC
GCATGGGTCGA -> CATGGGTCGAC
CCGTTGCGAAT -> CGTTGCGAATA
AGCCTCTGTAC -> GCCTCTGTACT
TCGACACGATT -> CGACACGATTC
GCGGTAGGATA -> CGGTAGGATAA
TCATGATTAGT -> CATGATTAGTC
CCCCTGTCGAC -> CCCTGTCGACC
CCCCGCTGGGG -> CCCGCTGGGGA
GTACCGGGTTC -> TACCGGGTTCT
CATGATTAGTC -> ATGATTAGTCC
TGTCGACCAAT -> GTCGACCAATT
CTGGCGCTCGT -> TGGCGCTCGTT
AATTGCGTCCT -> ATTGCGTCCTG
TCAACAATGAA -> CAACAATGAAA
TAGGAGTAACA -> AGGAGTAACAG
GCAAAAGGCCC -> CAAAAGGCCCC
GCTGGGGAGCC -> CTGGGGAGCCA
TGAGTATACAC -> GAGTATACACG
CTTTCTCTCAG -> TTTCTCTCAGC
GAGAGTCCCAC -> AGAGTCCCACC
GGACATTCCTT -> GACATTCCTTG
TCTTTTGAAAC -> CTTTTGAAACT
CGCGACCCGTA -> GCGACCCGTAT
ACGTCTATTCG -> CGTCTATTCGC
TTTCTCTCAGC -> TTCTCTCAGCT
TTTGAAACTAA -> TTGAAACTAAA
CGAACCCACGC -> GAACCCACGCA
AGAAGCAAAAA -> GAAGCAAAAAT
AGAAGAATTTA -> GAAGAATTTAG
AAGCAAAAATC -> AGCAAAAATCG
TACCGGGTTCT -> ACCGGGTTCTA
TCTACAACTTC -> CTACAACTTCG
CTCCTCACTTC -> TCCTCACTTCA
TGTTTGGCTAA -> GTTTGGCTAAT
CCTCACTTCAT -> CTCACTTCATG
CGGGAGCTCCT -> GGGAGCTCCTG
CAGTCGCCACC -> AGTCGCCACCA
TGTCGTGTTAA -> GTCGTGTTAAG
GCCTGTTGCGG -> CCTGTTGCGGC
TAGCTGAAAGG -> AGCTGAAAGGG
ACCTGCGGCGA -> CCTGCGGCGAA
CAGACACGAAA -> AGACACGAAAG
AAGATTGCCTC -> AGATTGCCTCT
AGCAGCAACAG -> GCAGCAACAGG
CGCACCGCAGT -> GCACCGCAGTT
TCAATCATGAA -> CAATCATGAAC
CTACAACTTCG -> TACAACTTCGT
AGATGGTCACA -> GATGGTCACAA
TGAATCCGCGG -> GAATCCGCGGG
AGGGATACACG -> GGGATACACGG
ATCACTCCCCT -> TCACTCCCCTG
TGGGGAGCCAT -> GGGGAGCCATC
GCCATGAAAAC -> CCATGAAAACC
GAGCAAGGCTC -> AGCAAGGCTCC
GCCATCAATAC -> CCATCAATACG
GTCGCCACCAG -> TCGCCACCAGT
ATTCAGCGCCA -> TTCAGCGCCAG
TTACTGGGTCC -> TACTGGGTCCT
CCTGCGGCGAA -> CTGCGGCGAAG
CGGACTCGAAA -> GGACTCGAAAT
TCGAAATTAAG -> CGAAATTAAGG
GGTCCTGGACG -> GTCCTGGACGG
TATTGGTCTCT -> ATTGGTCTCTG
GGACTATTGTT -> GACTATTGTTA
GAACCCACGCA -> AACCCACGCAA
AGTACCCGTCG -> GTACCCGTCGG
CACGTAGCTGT -> ACGTAGCTGTA
GGTCTAACAGT -> GTCTAACAGTC
AGGGTACCTCC -> GGGTACCTCCC
TTATAGTACCC -> TATAGTACCCG
GGCTCAGGGAT -> GCTCAGGGATA
GATAAGCCCAG -> ATAAGCCCAGC
GCTTGGCATGG -> CTTGGCATGGG
TGGTGAAGAGC -> GGTGAAGAGCA
CTGGGGTCTAA -> TGGGGTCTAAC
ACACAGGGTGA -> CACAGGGTGAT
GCTCGTTTAAT -> CTCGTTTAATT
AAAGGCAGAGG -> AAGGCAGAGGT
ATAGTTAGCTA -> TAGTTAGCTAG
AGGTCGAACGA -> GGTCGAACGAC
AGTCAATGGTC -> GTCAATGGTCG
CCGCTGGGGAG -> CGCTGGGGAGC
AAGCATTAGCA -> AGCATTAGCAG
ACAGGTTAAGT -> CAGGTTAAGTC
ACAGTCATAGA -> CAGTCATAGAG
ACTCCCCTGTC -> CTCCCCTGTCG
CTTGATGCCTA -> TTGATGCCTAA
AATCAAGCCGT -> ATCAAGCCGTT
AAAACCAGCCT -> AAACCAGCCTC
CACCAACACAT -> ACCAACACATA
TTCAACCTGCG -> TCAACCTGCGG
GAAAAGAACGG -> AAAAGAACGGA
GAACTTAGTAC -> AACTTAGTACG
TGGGTTGCTCG -> GGGTTGCTCGG
CCTGTCGACCA -> CTGTCGACCAA
CACGATTCGCC -> ACGATTCGCCT
TGAAATGGCAA -> GAAATGGCAAA
TTAGTACGCGC -> TAGTACGCGCT
GCTTCGACGCT -> CTTCGACGCTG
CACCGCAGTTT -> ACCGCAGTTTG
GCGCCTTAGGG -> CGCCTTAGGGG
TTAGTCCGCGC -> TAGTCCGCGCG
CGCAGTTTGAG -> GCAGTTTGAGT
ATTGCGTCCTG -> TTGCGTCCTGC
AGTAATAGCTG -> GTAATAGCTGA
AGCGCCAGTCG -> GCGCCAGTCGC
ATACCTCAAGT -> TACCTCAAGTC
CCCTGTCGACC -> CCTGTCGACCA
AAGAATGAGAG -> AGAATGAGAGT
TAATGGCATCT -> AATGGCATCTA
GTACTAGGGGT -> TACTAGGGGTG
GAGTAGCTAGG -> AGTAGCTAGGA
CTATAGTTAGC -> TATAGTTAGCT
GGTTAATGGCA -> GTTAATGGCAT
TAGTGCCGAGG -> AGTGCCGAGGA
AATACGGCGTC -> ATACGGCGTCG
TTAAACACAGG -> TAAACACAGGG
TGAAAAAGTCT -> GAAAAAGTCTA
TGCATGGGTCG -> GCATGGGTCGA
GACGGTTTGGA -> ACGGTTTGGAT
TTACACTTCGC -> TACACTTCGCC
TAGGGGTGTCG -> AGGGGTGTCGT
ACTAATGCGCA -> CTAATGCGCAT
GCGTAGTAATA -> CGTAGTAATAG
TGAGAGTTCTG -> GAGAGTTCTGC
TTATGGTTTAA -> TATGGTTTAAA
GGCGTCAAACG -> GCGTCAAACGT
AATCATGAACG -> ATCATGAACGA
CCACATCGAAC -> CACATCGAACG
TCTCTCAATCA -> CTCTCAATCAT
GTAGTAATAGC -> TAGTAATAGCT
CTAAAAGGCAG -> TAAAAGGCAGA
AGTCGCTAAAA -> GTCGCTAAAAG
ACTTCGCCATG -> CTTCGCCATGA
AGGCCTCTTTA -> GGCCTCTTTAT
AAAGGGGTAGG -> AAGGGGTAGGA
CGGTCTACAAC -> GGTCTACAACT
AACTATAGTTA -> ACTATAGTTAG
CTTTGTTCGGA -> TTTGTTCGGAG
CTCTTTTGAAA -> TCTTTTGAAAC
CAGTCTACCCC -> AGTCTACCCCC
ACGCCCGATCA -> CGCCCGATCAA
CGATCCATAGC -> GATCCATAGCT
ATAGCTGAAAG -> TAGCTGAAAGG
AGCCCAGCACA -> GCCCAGCACAT
GGTGAAGAGCA -> GTGAAGAGCAA
CTTCGACACGA -> TTCGACACGAT
CCCCCGACTCA -> CCCCGACTCAC
GCATAAGCCCC -> CATAAGCCCCG
GAAAACCAGCC -> AAAACCAGCCT
TCTGCGGTAGG -> CTGCGGTAGGA
CGACGCTGACG -> GACGCTGACGT
TCGCTAAAAGG -> CGCTAAAAGGC
CTGAGCGAACA -> TGAGCGAACAT
GCACCGTTGCG -> CACCGTTGCGA
GAAGCAGGTCG -> AAGCAGGTCGA
AAGTTTAGTTG -> AGTTTAGTTGA
GGTTAAGTCAT -> GTTAAGTCATA
TCATTACTGGG -> CATTACTGGGT
GACTGAATCCG -> ACTGAATCCGC
TATGGTTTAAA -> ATGGTTTAAAC
ATTCACCTTCC -> TTCACCTTCCC
TTGCGAATAGC -> TGCGAATAGCC
CTCACTGACCT -> TCACTGACCTA
GGTAGGTGCCT -> GTAGGTGCCTG
TACAGACACGA -> ACAGACACGAA
GAATTGCGTCC -> AATTGCGTCCT
GGTTGCTCGGT -> GTTGCTCGGTT
ATTCGCCTTAT -> TTCGCCTTATA
GGCTCCCCGAT -> GCTCCCCGATA
TTCGGCGTCAA -> TCGGCGTCAAA
ATTAGAGATTC -> TTAGAGATTCA
CTGGCCTTACA -> TGGCCTTACAC
TGAAGCAGGTC -> GAAGCAGGTCG
AACCAGCCTCT -> ACCAGCCTCTG
ACCAGTGTAGT -> CCAGTGTAGTT
CCATTCACCTT -> CATTCACCTTC
CACTTCGCCAT -> ACTTCGCCATG
GTTAACACTTG -> TTAACACTTGC
GCGGGATATGT -> CGGGATATGTT
GTCTACAACTT -> TCTACAACTTC
CGACAAGAAAA -> GACAAGAAAAG
CTGCTTCAACC -> TGCTTCAACCT
ACCTACAGACA -> CCTACAGACAC
ACTTTTTACCG -> CTTTTTACCGC
GATAACGTTGC -> ATAACGTTGCG
TTGATGCCTAA -> TGATGCCTAAC
GTCATCACAAG -> TCATCACAAGC
GAGATTCAGCG -> AGATTCAGCGC
GTTTTTGAGTA -> TTTTTGAGTAT
GAACGCCCGAT -> AACGCCCGATC
ATCCAGGTCAC -> TCCAGGTCACC
CCCGCTGGGGA -> CCGCTGGGGAG
GTAACCAAAGG -> TAACCAAAGGA
AATTAACTCCT -> ATTAACTCCTC
ATACAGAAGCA -> TACAGAAGCAA
ATAGCCTGAGA -> TAGCCTGAGAG
AATAGCCTGAG -> ATAGCCTGAGA
CAGATGGTCAC -> AGATGGTCACA
CTAGGATGGAA -> TAGGATGGAAG
GCCTGAGAGTT -> CCTGAGAGTTC
GACCTACAGAC -> ACCTACAGACA
CGGCTTCGACG -> GGCTTCGACGC
TTTCCACCACG -> TTCCACCACGT
CAGTCATAGAG -> AGTCATAGAGG
CAAGTCGCGGT -> AAGTCGCGGTC
CTCAATCATGA -> TCAATCATGAA
GATCCAGGTCA -> ATCCAGGTCAC
GTGTAGTTTTT -> TGTAGTTTTTG
CTCAAGTCGCG -> TCAAGTCGCGG
CTGAGAACCTG -> TGAGAACCTGT
CACCACGTCAT -> ACCACGTCATC
GTAGTTTTTGA -> TAGTTTTTGAG
GGTTTGGATTA -> GTTTGGATTAG
CATTCACCTTC -> ATTCACCTTCC
GCAAGGCTCCC -> CAAGGCTCCCC
TTGGCTAATAG -> TGGCTAATAGT
TGAAAATACCA -> GAAAATACCAG
GCTCGGTTAAT -> CTCGGTTAATC
ATCTGAAAATA -> TCTGAAAATAC
TTGCGTCCTGC -> TGCGTCCTGCT
CTGCGGTAGGA -> TGCGGTAGGAT
AACAATGAAAA -> ACAATGAAAAA
AAGGTAGGTGC -> AGGTAGGTGCC
GTTCAACAATG -> TTCAACAATGA
CAAAGACTGGG -> AAAGACTGGGG
CGTTGCGAATA -> GTTGCGAATAG
ATCATGAACGA -> TCATGAACGAA
TAAATGGTTAC -> AAATGGTTACG
GTCCGCGCGTA -> TCCGCGCGTAG
GAGTCCCACCC -> AGTCCCACCCG
TTCAGCGCCAG -> TCAGCGCCAGT
AATGGCATCTA -> ATGGCATCTAC
AGTCATAATTA -> GTCATAATTAG
CTGGGGAGCCA -> TGGGGAGCCAT
TGCGGTAGGAT -> GCGGTAGGATA
TAAGAGTTGAA -> AAGAGTTGAAG
AGTCCGCGCGT -> GTCCGCGCGTA
AACTAAATGGT -> ACTAAATGGTT
CCAGTCGCCAC -> CAGTCGCCACC
TAATCAAGCCG -> AATCAAGCCGT
CTGGGTCCTGG -> TGGGTCCTGGA
GGCCCCTGAGA -> GCCCCTGAGAA
TTTTGAAACTA -> TTTGAAACTAA
GCAATCAGATG -> CAATCAGATGG
TTCGACGCTGA -> TCGACGCTGAC
CTTCGTCATCA -> TTCGTCATCAC
AACTTCGTCAT -> ACTTCGTCATC
CACATAACCGG -> ACATAACCGGA
ATGGTTTAAAC -> TGGTTTAAACA
CCGAGGACATT -> CGAGGACATTC
GGGAGCCATCA -> GGAGCCATCAA
CGAGTAGCTAG -> GAGTAGCTAGG
GTTTAATTATA -> TTTAATTATAG
GCCTCTGTACT -> CCTCTGTACTA
CTTCGCTTCTT -> TTCGCTTCTTC
ACCTCAAGTCG -> CCTCAAGTCGC
CTACTCTCGGG -> TACTCTCGGGA
TCTAGCTTGGC -> CTAGCTTGGCA
CAAAGGAATTA -> AAAGGAATTAT
AGAATTTAGTC -> GAATTTAGTCA
ATTCCTTGATG -> TTCCTTGATGC
TCTAGCTGAGC -> CTAGCTGAGCG
AAGAATTTAGT -> AGAATTTAGTC
CACGTCATCTG -> ACGTCATCTGA
GTGAAGAGCAA -> TGAAGAGCAAG
CATTAGCAGCT -> ATTAGCAGCTA
AAGCTAATAAA -> AGCTAATAAAT
TCCATAGCTAG -> CCATAGCTAGG
CCCGATCAAAT -> CCGATCAAATT
TCTTTATTGGT -> CTTTATTGGTC
AAAGAACGGAC -> AAGAACGGACT
GCCCCGCTGGG -> CCCCGCTGGGG
AGAAAGAATGA -> GAAAGAATGAG
GGGTAGGAGTA -> GGTAGGAGTAA
ACACGGCTTCG -> CACGGCTTCGA
GTTTGGCTAAT -> TTTGGCTAATA
TCACTCCCCTG -> CACTCCCCTGT
AACAGTCTAGC -> ACAGTCTAGCT
TGAAACTAAAT -> GAAACTAAATG
ATAGTACCCGT -> TAGTACCCGTC
AAGAAAAGAAC -> AGAAAAGAACG
CCACCAGTCTA -> CACCAGTCTAC
GGTCACAATAT -> GTCACAATATC
TCACCAACACA -> CACCAACACAT
AGACACGAAAG -> GACACGAAAGG
CAAGCTAATAA -> AAGCTAATAAA
ACAGAAGCAAA -> CAGAAGCAAAA
CTTCATGATTA -> TTCATGATTAG
CATGGGTTGCT -> ATGGGTTGCTC
AGTAACAGTCT -> GTAACAGTCTA
AGCAAAAGGCC -> GCAAAAGGCCC
GCTTCTTCGGG -> CTTCTTCGGGC
CCGTATAGGGG -> CGTATAGGGGT
TGCGCCTTAGG -> GCGCCTTAGGG
ATAGCTAGGTG -> TAGCTAGGTGG
CAAAAATCGAA -> AAAAATCGAAC
AGCAGCTAACC -> GCAGCTAACCT
CTCAGCTGGCG -> TCAGCTGGCGC
GGAGGGAGCAC -> GAGGGAGCACC
TAAGGGTACCT -> AAGGGTACCTC
CCCGATAACGT -> CCGATAACGTT
CCGATCCAGGT -> CGATCCAGGTC
GATTATCACTC -> ATTATCACTCC
CGTCAAACGTC -> GTCAAACGTCT
AAACCAGCCTC -> AACCAGCCTCT
CGTTTTCCACC -> GTTTTCCACCA
CTGCATGGGTC -> TGCATGGGTCG
GAATGAGAGTC -> AATGAGAGTCC
CAATCTAGGAT -> AATCTAGGATG
CTTCGACGCTG -> TTCGACGCTGA
AGCTGTAGTGC -> GCTGTAGTGCC
TAGCTAGGAGG -> AGCTAGGAGGG
AGCTAATAAAT -> GCTAATAAATC
GATTCGCCTTA -> ATTCGCCTTAT
ACGAAAGGTAG -> CGAAAGGTAGG
TCGGCGTCAAA -> CGGCGTCAAAC
CAATTTGACTG -> AATTTGACTGA
CGCGAATACCC -> GCGAATACCCA
TGTTAAGGGTA -> GTTAAGGGTAC
CCTCTGTACTA -> CTCTGTACTAG
CCTTGATGCCT -> CTTGATGCCTA
CCGTTTTCCAC -> CGTTTTCCACC
CCAGCGGACTC -> CAGCGGACTCG
TCAAGTCGCGG -> CAAGTCGCGGT
TCGGTCCTTTC -> CGGTCCTTTCT
CCACGTCATCT -> CACGTCATCTG
TAAGTCATAAT -> AAGTCATAATT
ACGTGAGTTCA -> CGTGAGTTCAA
CATGTGGTGAA -> ATGTGGTGAAG
GCTGAAAGGGG -> CTGAAAGGGGT
CACTGACCTAC -> ACTGACCTACA
TACCTCAAGTC -> ACCTCAAGTCG
GATTAGTCCGC -> ATTAGTCCGCG
TCGTACGCGAA -> CGTACGCGAAT
TGGATTAGTTA -> GGATTAGTTAA
GCAGAGGTTAC -> CAGAGGTTACG
CCAAAGGAATT -> CAAAGGAATTA
GATGGAACTTA -> ATGGAACTTAG
GCACCGCAGTT -> CACCGCAGTTT
AAAAGGCCCCC -> AAAGGCCCCCG
GGTCCTTTCTC -> GTCCTTTCTCT
AATGGTCGGTC -> ATGGTCGGTCC
ATGAACGAAAT -> TGAACGAAATT
GTAGCTAGGAG -> TAGCTAGGAGG
AGATTATCACT -> GATTATCACTC
CGTGAGTTCAA -> GTGAGTTCAAC
CACATCGAACG -> ACATCGAACGC
TCATCTGAAAA -> CATCTGAAAAT
GCAGTTTGAGT -> CAGTTTGAGTC
TGCGGCCGGCC -> GCGGCCGGCCA
AATTAAGGAAA -> ATTAAGGAAAG
ACTAGGGGTGC -> CTAGGGGTGCG
AGTAGCTAGGA -> GTAGCTAGGAG
TAGAGGCCTCT -> AGAGGCCTCTT
AAGTCATAATT -> AGTCATAATTA
ACCGCGACCCG -> CCGCGACCCGT
CTAAATGGTTA -> TAAATGGTTAC
AAATTACTTTT -> AATTACTTTTT
ACTCGAAATTA -> CTCGAAATTAA
GTATACACGTA -> TATACACGTAG
GCTCTTGGCAG -> CTCTTGGCAGC
GTCCTTTCTCT -> TCCTTTCTCTC
CTAACCTATAT -> TAACCTATATA
ACACGATTCGC -> CACGATTCGCC
TGAGTTCAACA -> GAGTTCAACAA
CGGTTTGGATT -> GGTTTGGATTA
CAGCGACGTCT -> AGCGACGTCTG
AAATCGAACCC -> AATCGAACCCA
TGATGGAACTT -> GATGGAACTTA
ATTAGTCCGCG -> TTAGTCCGCGC
TCAACCTGCGG -> CAACCTGCGGC
ACGTCGTTAAG -> CGTCGTTAAGG
ACTAAATGGTT -> CTAAATGGTTA
ATTATGGTTTA -> TTATGGTTTAA
GATGCCTAACT -> ATGCCTAACTA
GTGTCGTGTTA -> TGTCGTGTTAA
TGACTGAATCC -> GACTGAATCCG
ATAAGCCCCGC -> TAAGCCCCGCT
TAATCATGTGG -> AATCATGTGGT
CTACCCCCGAC -> TACCCCCGACT
GGTTACGTCGT -> GTTACGTCGTT
TGGTTAATGGC -> GGTTAATGGCA
GAGAACCTGTT -> AGAACCTGTTG
TCCTGCTTCAA -> CCTGCTTCAAC
TACCTCCCACA -> ACCTCCCACAT
CTCCTGATCAT -> TCCTGATCATA
TACCCGTCGGC -> ACCCGTCGGCG
GTCTAACAGTC -> TCTAACAGTCA
TTGTTAAGGGT -> TGTTAAGGGTA
TAAGCCCCGCT -> AAGCCCCGCTG
CAGCCTCTGTA -> AGCCTCTGTAC
CTGTACTAGGG -> TGTACTAGGGG
TGCGCATAAGC -> GCGCATAAGCC
GTTCGGCGTCA -> TTCGGCGTCAA
TCTACGGCTTC -> CTACGGCTTCG
TTAAGAGTTGA -> TAAGAGTTGAA
CGCTGGGGAGC -> GCTGGGGAGCC
TGCAATCAGAT -> GCAATCAGATG
CTCGCCTCATA -> TCGCCTCATAC
CACTTGCAATC -> ACTTGCAATCT
GTTTTCCACCA -> TTTTCCACCAC
AATAGTGAAAT -> ATAGTGAAATG
GTACCCGTCGG -> TACCCGTCGGC
TCTAACAGTCA -> CTAACAGTCAT
CCTAACTATAG -> CTAACTATAGT
AGAGTTCTGCA -> GAGTTCTGCAT
GGCCTCTTTAT -> GCCTCTTTATT
ATACACGTAGC -> TACACGTAGCT
CGCGGTCTACA -> GCGGTCTACAA
TGAAAACCAGC -> GAAAACCAGCC
GTGTTAAGATC -> TGTTAAGATCC
CTAGGAGGGAG -> TAGGAGGGAGC
TTTTACCGCGA -> TTTACCGCGAC
TGGTCGGTCCT -> GGTCGGTCCTT
TCGGGCTCAGG -> CGGGCTCAGGG
ATTGTTAAGGG -> TTGTTAAGGGT
TGTTAAGAGTT -> GTTAAGAGTTG
TGCCTGTTGCG -> GCCTGTTGCGG
TTTGACTGAAT -> TTGACTGAATC
TGGCGCGATAA -> GGCGCGATAAG
CGTTCGGCGTC -> GTTCGGCGTCA
ACCGTTGCGAA -> CCGTTGCGAAT
GACGGCAATCG -> ACGGCAATCGG
CTCTCTCTCAA -> TCTCTCTCAAT
CAAATACCTCA -> AAATACCTCAA
CAATCGGTGTG -> AATCGGTGTGC
TTCTCTCAGCT -> TCTCTCAGCTG
TGAAGAGCAAG -> GAAGAGCAAGG
AGCAGGTCGAA -> GCAGGTCGAAC
CTCTGTACTAG -> TCTGTACTAGG
AAATGGTTACG -> AATGGTTACGG
TGAGTCTTTGT -> GAGTCTTTGTT
ATCACAAGCAG -> TCACAAGCAGC
CACTTCATGAT -> ACTTCATGATT
CTAGCTGAGCG -> TAGCTGAGCGA
TTTAGTTGAAG -> TTAGTTGAAGA
CAGTTTGAGTC -> AGTTTGAGTCT
CAGCGCCAGTC -> AGCGCCAGTCG
AGTTTAGTTGA -> GTTTAGTTGAA
TCTCGCCTCAT -> CTCGCCTCATA
CGAGGACATTC -> GAGGACATTCC
AATGCGCATAA -> ATGCGCATAAG
TGATGCCTAAC -> GATGCCTAACT
CGCCGATCCAG -> GCCGATCCAGG
GTCACCAACAC -> TCACCAACACA
CGGCCATCAAT -> GGCCATCAATA
GCAGGTCGAAC -> CAGGTCGAACG
CGGAAGAAGAA -> GGAAGAAGAAT
TTAAGGAAAGT -> TAAGGAAAGTC
CGGATCAAGCT -> GGATCAAGCTA
TACACTTCGCC -> ACACTTCGCCA
GATACACGGCT -> ATACACGGCTT
TACGCGCTGGC -> ACGCGCTGGCC
ACGCAAAGACT -> CGCAAAGACTG
GTTGCGCCTTA -> TTGCGCCTTAG
ATCCGCGGGAT -> TCCGCGGGATA
TTCGCACTGAA -> TCGCACTGAAT
GCTTCGCTTCT -> CTTCGCTTCTT
CTTCAACCTGC -> TTCAACCTGCG
TATACCTCTCT -> ATACCTCTCTC
TATAGGGGTGT -> ATAGGGGTGTC
AGGCCCCTGAG -> GGCCCCTGAGA
CTTTATTGGTC -> TTTATTGGTCT
CTTATATACCT -> TTATATACCTC
TACGTCGTTAA -> ACGTCGTTAAG
CATAAGCCCCG -> ATAAGCCCCGC
CCCCCGGAAGA -> CCCCGGAAGAA
TACGCGAATAC -> ACGCGAATACC
GCTAGGAGGGA -> CTAGGAGGGAG
ATTATTCGTTC -> TTATTCGTTCG
CGGCTCTTGGC -> GGCTCTTGGCA
CTATTCGCACT -> TATTCGCACTG
GGCGCCCCCTC -> GCGCCCCCTCT
CTGACGATCCA -> TGACGATCCAT
CTATTGTTAAG -> TATTGTTAAGG
AACGTCTATTC -> ACGTCTATTCG
GCGCATAAGCC -> CGCATAAGCCC
AAATTAAGGAA -> AATTAAGGAAA
CGGCGTCGTAC -> GGCGTCGTACG
GTGAGTTCAAC -> TGAGTTCAACA
CTAGGTGGCGC -> TAGGTGGCGCG
AAGTCGCGGTC -> AGTCGCGGTCT
GAAGAGCAAGG -> AAGAGCAAGGC
ACAGGGTGATG -> CAGGGTGATGG
GGGTTGCTCGG -> GGTTGCTCGGT
CGGTTAATCAA -> GGTTAATCAAG
TTCCCGCCTTC -> TCCCGCCTTCG
GACCCGTATAG -> ACCCGTATAGG
TTGCTCGGTTA -> TGCTCGGTTAA
GCAATCGGTGT -> CAATCGGTGTG
GTCTCTGCGGT -> TCTCTGCGGTA
CTGCGGCGAAG -> TGCGGCGAAGC
TGCTTCAACCT -> GCTTCAACCTG
CCCTCTTTTGA -> CCTCTTTTGAA
CATACAGAAGC -> ATACAGAAGCA
CACATACGTGG -> ACATACGTGGT
GCCTAACTATA -> CCTAACTATAG
GCATGGGTTGC -> CATGGGTTGCT
GCCTTACACTT -> CCTTACACTTC
GGTTCTACGGC -> GTTCTACGGCT
CGTCGGCGTTA -> GTCGGCGTTAA
CCTGAGAGTTC -> CTGAGAGTTCT
TTGGATTAGTT -> TGGATTAGTTA
TAAATCGAGTA -> AAATCGAGTAG
AGGCAGAGGTT -> GGCAGAGGTTA
AGCCCCGCTGG -> GCCCCGCTGGG
TTGCCTCTCGC -> TGCCTCTCGCC
CCTTTCTCTCA -> CTTTCTCTCAG
CTGAAAATACC -> TGAAAATACCA
CAGCAACAGGT -> AGCAACAGGTT
AAGCCGTTTTC -> AGCCGTTTTCC
CAGGTCGAACG -> AGGTCGAACGA
GGTGGCGCGAT -> GTGGCGCGATA
CCTGCTTCAAC -> CTGCTTCAACC
CACCGTTGCGA -> ACCGTTGCGAA
GACATTCCTTG -> ACATTCCTTGA
TTTTTACCGCG -> TTTTACCGCGA
CGCATAAGCCC -> GCATAAGCCCC
TTTTGAGTATA -> TTTGAGTATAC
CTGTTGCGGCC -> TGTTGCGGCCG
GGGGTAGGAGT -> GGGTAGGAGTA
AATTTAGTCAA -> ATTTAGTCAAT
TTGTTCGGAGA -> TGTTCGGAGAG
CAAACGTCTAT -> AAACGTCTATT
CTGTCGACCAA -> TGTCGACCAAT
AGAACCTGTTG -> GAACCTGTTGT
TGTTGTCATTA -> GTTGTCATTAC
GAGCGAACATA -> AGCGAACATAA
TAACCGGATCA -> AACCGGATCAA
CTGACGTGAGT -> TGACGTGAGTT
TAGGGGTGCGA -> AGGGGTGCGAC
GAGCTCCTGAT -> AGCTCCTGATC
TCATCACAAGC -> CATCACAAGCA
AGGAAAGTCAG -> GGAAAGTCAGC
TTTAATTATAG -> TTAATTATAGT
GTTCGGAGAGT -> TTCGGAGAGTA
TGGTTACGGCT -> GGTTACGGCTC
GGTCTCTGCGG -> GTCTCTGCGGT
TCCAGGTCACC -> CCAGGTCACCA
CGCTGGCCTTA -> GCTGGCCTTAC
TTAGCAGCTAA -> TAGCAGCTAAC
AGAGTTGAAGA -> GAGTTGAAGAT
CGAAAGGTAGG -> GAAAGGTAGGT
AGCAACAGGTT -> GCAACAGGTTA
GATATGTTAAG -> ATATGTTAAGA
CACAGGGTGAT -> ACAGGGTGATG
AATGAAGCAGG -> ATGAAGCAGGT
CTTTTTACCGC -> TTTTTACCGCG
GCGGCCGGCCA -> CGGCCGGCCAT
TCCTTTCTCTC -> CCTTTCTCTCA
CTCTTGGCAGC -> TCTTGGCAGCG
ACTCCTCACTT -> CTCCTCACTTC
CGCCTTAGGGG -> GCCTTAGGGGC
GTAACAGTCTA -> TAACAGTCTAG
CTTCGGGCTCA -> TTCGGGCTCAG
ACAACTTCGTC -> CAACTTCGTCA
AAACTAAATGG -> AACTAAATGGT
AATCGAGTAGC -> ATCGAGTAGCT
CGATTCGCCTT -> GATTCGCCTTA
GGCATGGGTTG -> GCATGGGTTGC
ATAAATCGAGT -> TAAATCGAGTA
TGGCTAATAGT -> GGCTAATAGTG
GGGTGTCGTGT -> GGTGTCGTGTT
GAAAGAATGAG -> AAAGAATGAGA
TGGACGGTTTG -> GGACGGTTTGG
ATTAGTTAAGA -> TTAGTTAAGAA
CCTGGACGGTT -> CTGGACGGTTT
CCTCCCACATC -> CTCCCACATCG
GGTCGACAAGA -> GTCGACAAGAA
GAAATTAAGGA -> AAATTAAGGAA
ACCAGCCTCTG -> CCAGCCTCTGT
GGCGTCGTACG -> GCGTCGTACGC
AGCTGGCGCTC -> GCTGGCGCTCG
TAGGATAATCA -> AGGATAATCAT
TCCCCGATAAC -> CCCCGATAACG
CCGCGGGATAT -> CGCGGGATATG
TAGCTGAGCGA -> AGCTGAGCGAA
CGCCATGAAAA -> GCCATGAAAAC
CGTTAAGGCCC -> GTTAAGGCCCC
AATTATTCGTT -> ATTATTCGTTC
TGTAGTTTTTG -> GTAGTTTTTGA
GGGGCGCCCCC -> GGGCGCCCCCT
TACTGGGTCCT -> ACTGGGTCCTG
GCGACGCCGAT -> CGACGCCGATC
AGTGCCGAGGA -> GTGCCGAGGAC
CACCAGTCTAC -> ACCAGTCTACC
TGCGACGCCGA -> GCGACGCCGAT
TCTCTGCGGTA -> CTCTGCGGTAG
CAGAAGCAAAA -> AGAAGCAAAAA
TACGGCGTCGT -> ACGGCGTCGTA
TACTAGGGGTG -> ACTAGGGGTGC
CGCTAAAAGGC -> GCTAAAAGGCA
GTTAAGAAAGA -> TTAAGAAAGAA
GCCATCAAGTT -> CCATCAAGTTT
GCAGCAACAGG -> CAGCAACAGGT
CGCGATAAGCC -> GCGATAAGCCC
GTAGGTGCCTG -> TAGGTGCCTGT
AAGTCTAGCTT -> AGTCTAGCTTG
ACGCGAATACC -> CGCGAATACCC
GGCAGCGACGT -> GCAGCGACGTC
CCCACGCAAAG -> CCACGCAAAGA
GGAAGTACCGG -> GAAGTACCGGG
CCCGCCTTCGA -> CCGCCTTCGAC
AGGTTACGTCG -> GGTTACGTCGT
GAAGAAGAATT -> AAGAAGAATTT
AAAGGTAGGTG -> AAGGTAGGTGC
CACCTTCCCGC -> ACCTTCCCGCC
CTGTAGTGCCG -> TGTAGTGCCGA
GGAGAGTAACC -> GAGAGTAACCA
AGTCATAGAGG -> GTCATAGAGGC
GTCATCTGAAA -> TCATCTGAAAA
ACCACGTCATC -> CCACGTCATCT
CATAGCTAGGT -> ATAGCTAGGTG
AGAGGTTACGT -> GAGGTTACGTC
TATTGTTAAGG -> ATTGTTAAGGG
TACCGCGACCC -> ACCGCGACCCG
CGCCACCAGTC -> GCCACCAGTCT
GGTAGGAGTAA -> GTAGGAGTAAC
CGCCTCATACA -> GCCTCATACAG
AACGAAATTAA -> ACGAAATTAAC
ACGTCATCTGA -> CGTCATCTGAA
CAGAGGTTACG -> AGAGGTTACGT
CTCCCACATCG -> TCCCACATCGA
ACCTTCCCGCC -> CCTTCCCGCCT
AGTCAGCAAAA -> GTCAGCAAAAG
CGGAGAGTAAC -> GGAGAGTAACC
TTTGAGTATAC -> TTGAGTATACA
CCCACCCGCAC -> CCACCCGCACC
ATAGTGAAATG -> TAGTGAAATGG
ACTTAGTACGC -> CTTAGTACGCG
GGCATCTACTC -> GCATCTACTCT
CGCCTTCGACA -> GCCTTCGACAC
TTAGGGGCGCC -> TAGGGGCGCCC
GAAAATACCAG -> AAAATACCAGT
ACATTCCTTGA -> CATTCCTTGAT
TACACGTAGCT -> ACACGTAGCTG
CCATCAAGTTT -> CATCAAGTTTA
TGACGTGAGTT -> GACGTGAGTTC
GAACGACGGCA -> AACGACGGCAA
TCCACCACGTC -> CCACCACGTCA
GAGAGTAACCA -> AGAGTAACCAA
GTCGTTAAGGC -> TCGTTAAGGCC
CGTCTGACGAT -> GTCTGACGATC
TACCTCTCTCT -> ACCTCTCTCTC
TAGTCAATGGT -> AGTCAATGGTC
AGACTGGGGTC -> GACTGGGGTCT
TCGTTAAGGCC -> CGTTAAGGCCC
GCTCCCCGATA -> CTCCCCGATAA
CAATCATGAAC -> AATCATGAACG
TTACTTTTTAC -> TACTTTTTACC
AATTTGACTGA -> ATTTGACTGAA
GGATAATCATG -> GATAATCATGT
TGAGCGAACAT -> GAGCGAACATA
TAGTACGCGCT -> AGTACGCGCTG
GCGACCCGTAT -> CGACCCGTATA
ACGGCTTCGCT -> CGGCTTCGCTT
CGGCGTTAACA -> GGCGTTAACAC
GTGTTTGGCTA -> TGTTTGGCTAA
GGAAGAAGAAT -> GAAGAAGAATT
AATAGCTGAAA -> ATAGCTGAAAG
AAGGCCCCTGA -> AGGCCCCTGAG
CGGCGTCAAAC -> GGCGTCAAACG
GCGTCAAACGT -> CGTCAAACGTC
TTCGCCATGAA -> TCGCCATGAAA
GCTAATAGTGA -> CTAATAGTGAA
GGGAGCACCGT -> GGAGCACCGTT
TCTCGGGAGCT -> CTCGGGAGCTC
CAATACGGCGT -> AATACGGCGTC
ATTACTTTTTA -> TTACTTTTTAC
TGAAGATTGCC -> GAAGATTGCCT
TTAATCAAGCC -> TAATCAAGCCG
CAAGGCTCCCC -> AAGGCTCCCCG
CTCTCGCCTCA -> TCTCGCCTCAT
CGATCCAGGTC -> GATCCAGGTCA
TACACGGCTTC -> ACACGGCTTCG
CAAATTACTTT -> AAATTACTTTT
GAGCCATCAAG -> AGCCATCAAGT
AAAGGAATTAT -> AAGGAATTATT
TTAATTATAGT -> TAATTATAGTA
CCAGGTCACCA -> CAGGTCACCAA
GTTGCGAATAG -> TTGCGAATAGC
AGAGGCCTCTT -> GAGGCCTCTTT
TATCCATTCAC -> ATCCATTCACC
AAGGAAAGTCA -> AGGAAAGTCAG
CGGGATATGTT -> GGGATATGTTA
CGCGGGATATG -> GCGGGATATGT
GTTCTACGGCT -> TTCTACGGCTT
ATCATACTCTT -> TCATACTCTTA
CATCAAGTTTA -> ATCAAGTTTAG
GGCGCGATAAG -> GCGCGATAAGC
CTCTTTATTGG -> TCTTTATTGGT
AGCTTGGCATG -> GCTTGGCATGG
ATCAAGTTTAG -> TCAAGTTTAGT
AAGATTATCAC -> AGATTATCACT
ATGGGTCGACA -> TGGGTCGACAA
TTATTCGTTCG -> TATTCGTTCGG
AAGAACGGACT -> AGAACGGACTA
TTCTGCATGGG -> TCTGCATGGGT
ACTGGGGTCTA -> CTGGGGTCTAA
CGGGTTCTACG -> GGGTTCTACGG
ACTGGGTCCTG -> CTGGGTCCTGG
CTTAGGGGCGC -> TTAGGGGCGCC
ACACTTGCAAT -> CACTTGCAATC
GCTGACGTGAG -> CTGACGTGAGT
TAATGCGCATA -> AATGCGCATAA
GGATGGAAGTA -> GATGGAAGTAC
ATCGAACCCAC -> TCGAACCCACG
TAGTTAGCTAG -> AGTTAGCTAGT
GTTAAGATCCC -> TTAAGATCCCC
GGGTCGACAAG -> GGTCGACAAGA
TGCGTCCTGCT -> GCGTCCTGCTT
GAATTTAGTCA -> AATTTAGTCAA
TTTGTTCGGAG -> TTGTTCGGAGA
AGTACGCGCTG -> GTACGCGCTGG
ACACGAAAGGT -> CACGAAAGGTA
AGCCATCAAGT -> GCCATCAAGTT
GCTAACCTATA -> CTAACCTATAT
CGATAACGTTG -> GATAACGTTGC
GTCTAGCTTGG -> TCTAGCTTGGC
AAGCAGGTCGA -> AGCAGGTCGAA
GAAGATTATCA -> AAGATTATCAC
GCTTCAACCTG -> CTTCAACCTGC
ATTACTGGGTC -> TTACTGGGTCC
AACTCCTCACT -> ACTCCTCACTT
AGTCTACCCCC -> GTCTACCCCCG
ATCAGATGGTC -> TCAGATGGTCA
TGGCGCTCGTT -> GGCGCTCGTTT
CAACCTGCGGC -> AACCTGCGGCG
TTCGTTCGGCG -> TCGTTCGGCGT
CTAGTCGCTAA -> TAGTCGCTAAA
TACGTGGTTAA -> ACGTGGTTAAT
AGTTCAACAAT -> GTTCAACAATG
AGCACCGTTGC -> GCACCGTTGCG
CTGAATCCGCG -> TGAATCCGCGG
CCCCTGAGAAC -> CCCTGAGAACC
TGAATTGCGTC -> GAATTGCGTCC
CCTCTTTTGAA -> CTCTTTTGAAA
GAGGGAGCACC -> AGGGAGCACCG
ATCAAGCTAAT -> TCAAGCTAATA
TGTTCGGAGAG -> GTTCGGAGAGT
AATGTTTACTA -> ATGTTTACTAA
CATAACCGGAT -> ATAACCGGATC
GACGCTGACGT -> ACGCTGACGTG
TGTGCAATCAG -> GTGCAATCAGA
ATAACGTTGCG -> TAACGTTGCGC
ACCCGTCGGCG -> CCCGTCGGCGT
GTCTGACGATC -> TCTGACGATCC
TTGAGTCTTTG -> TGAGTCTTTGT
CTTAGTACGCG -> TTAGTACGCGC
TTAACACTTGC -> TAACACTTGCA
ACCAATTTGAC -> CCAATTTGACT
GGTCTACAACT -> GTCTACAACTT
TAAGATCCCCG -> AAGATCCCCGT
TCATAATTAGA -> CATAATTAGAG
GTCAATGGTCG -> TCAATGGTCGG
AGTTGAAGATT -> GTTGAAGATTA,GTTGAAGATTG
TGCGGCGAAGC -> GCGGCGAAGCA
GAAGCAAAAAT -> AAGCAAAAATC
GCCTCTCGCCT -> CCTCTCGCCTC
AAATCGAGTAG -> AATCGAGTAGC
GCCCCCTCTTT -> CCCCCTCTTTT
AGGGTGATGGA -> GGGTGATGGAA
TCAAACGTCTA -> CAAACGTCTAT
CATCTACTCTC -> ATCTACTCTCG
GGTCACCAACA -> GTCACCAACAC
TCGTTCGGCGT -> CGTTCGGCGTC
GTCTTTGTTCG -> TCTTTGTTCGG
GTTTGAGTCTT -> TTTGAGTCTTT
GTCGAACGACG -> TCGAACGACGG
CAAGAAAAGAA -> AAGAAAAGAAC
CGAAATTAAGG -> GAAATTAAGGA
AAAGTCAGCAA -> AAGTCAGCAAA
GGATTAGTTAA -> GATTAGTTAAG
TACGGCTCTTG -> ACGGCTCTTGG
GTCAAACGTCT -> TCAAACGTCTA
AGGGAGCACCG -> GGGAGCACCGT
AGATTCAGCGC -> GATTCAGCGCC
ATCTAGGATGG -> TCTAGGATGGA
TGCCTAACTAT -> GCCTAACTATA
CCGGATCAAGC -> CGGATCAAGCT
AAGTACCGGGT -> AGTACCGGGTT
TGGTCACAATA -> GGTCACAATAT
TCAATGGTCGG -> CAATGGTCGGT
GTCGGTCCTTT -> TCGGTCCTTTC
TCACTTCATGA -> CACTTCATGAT
GCCGTTTTCCA -> CCGTTTTCCAC
TAAATGTTTAC -> AAATGTTTACT
CGTCGTACGCG -> GTCGTACGCGA
AATCTAGGATG -> ATCTAGGATGG
GACTCACTGAC -> ACTCACTGACC
TAATAGTGAAA -> AATAGTGAAAT
CTAACTATAGT -> TAACTATAGTT
CCACCACGTCA -> CACCACGTCAT
TCTTCGGGCTC -> CTTCGGGCTCA
TTTACTAATGC -> TTACTAATGCG
GCGACGTCTGA -> CGACGTCTGAC
GTGCGACGCCG -> TGCGACGCCGA
GTGCCGAGGAC -> TGCCGAGGACA
CTCACTTCATG -> TCACTTCATGA
ACGGACTATTG -> CGGACTATTGT
GCTAATAAATC -> CTAATAAATCG
TGATCATACTC -> GATCATACTCT
CCCAGCACATA -> CCAGCACATAC
TAGTTTTTGAG -> AGTTTTTGAGT
GATCATACTCT -> ATCATACTCTT
TCTATTCGCAC -> CTATTCGCACT
GGCGTTAACAC -> GCGTTAACACT
GGCCTTACACT -> GCCTTACACTT
CCGATAACGTT -> CGATAACGTTG
TTCGGAGAGTA -> TCGGAGAGTAA
GTGCAATCAGA -> TGCAATCAGAT
ATGGTCGGTCC -> TGGTCGGTCCT
CTTCTTCGGGC -> TTCTTCGGGCT
ATTCGTTCGGC -> TTCGTTCGGCG
TCAGCAAAAGG -> CAGCAAAAGGC
AGCTGAAAGGG -> GCTGAAAGGGG
TTGAAACTAAA -> TGAAACTAAAT
CGACGCCGATC -> GACGCCGATCC
TATATACCTCT -> ATATACCTCTC
CCGCGCGTAGT -> CGCGCGTAGTA
CCTCATACAGA -> CTCATACAGAA
TAAGAAAGAAT -> AAGAAAGAATG
TAACAGTCATA -> AACAGTCATAG
CCCGTATAGGG -> CCGTATAGGGG
AGTCGCCACCA -> GTCGCCACCAG
CGGTGTGCAAT -> GGTGTGCAATC
TTACGTCGTTA -> TACGTCGTTAA
GACGTCTGACG -> ACGTCTGACGA
GGCTTCGACGC -> GCTTCGACGCT
TCCTCACTTCA -> CCTCACTTCAT
TAGTTAAGAAA -> AGTTAAGAAAG
CTGATCATACT -> TGATCATACTC
GAGTTGAAGAT -> AGTTGAAGATT
CGGCAATCGGT -> GGCAATCGGTG
GGGGTGCGACG -> GGGTGCGACGC
AGCAAAAATCG -> GCAAAAATCGA
TTTACCGCGAC -> TTACCGCGACC
TCCCCTGTCGA -> CCCCTGTCGAC
ACGGCGTCGTA -> CGGCGTCGTAC
GGACGGTTTGG -> GACGGTTTGGA
GATCCCCGTGT -> ATCCCCGTGTT
CGTAGTAATAG -> GTAGTAATAGC
CATAGAGGCCT -> ATAGAGGCCTC
GCCACCAGTCT -> CCACCAGTCTA
ATAGGGGTGTC -> TAGGGGTGTCG
GTTACGTCGTT -> TTACGTCGTTA
GTCCCACCCGC -> TCCCACCCGCA
TAGGTGCCTGT -> AGGTGCCTGTT
GCAATCTAGGA -> CAATCTAGGAT
GGCCCCCGGAA -> GCCCCCGGAAG
GTCATTACTGG -> TCATTACTGGG
CAGGTTAAGTC -> AGGTTAAGTCA
CCCCGTGTTTG -> CCCGTGTTTGG
CGCCTTATATA -> GCCTTATATAC
AACGCCCGATC -> ACGCCCGATCA
AATACCAGTGT -> ATACCAGTGTA
CGTCATCACAA -> GTCATCACAAG
CACGAAAGGTA -> ACGAAAGGTAG
CATTCCTTGAT -> ATTCCTTGATG
AGCAAGGCTCC -> GCAAGGCTCCC
CGTGTTAAGAT -> GTGTTAAGATC
CTTGCAATCTA -> TTGCAATCTAG
CACTCCCCTGT -> ACTCCCCTGTC
CTGACCTACAG -> TGACCTACAGA
TGAGAACCTGT -> GAGAACCTGTT
ACCAGTCTACC -> CCAGTCTACCC
GCTAAAAGGCA -> CTAAAAGGCAG
CTAATGCGCAT -> TAATGCGCATA
GTTGAAGATTA -> TTGAAGATTAT
GTTGAAGATTG -> TTGAAGATTGC
TTCAACAATGA -> TCAACAATGAA
GGTGATGGAAC -> GTGATGGAACT
AGGTTAAGTCA -> GGTTAAGTCAT
CAATGAAAAAG -> AATGAAAAAGT
CGGCCGGCCAT -> GGCCGGCCATC
AGATCCCCGTG -> GATCCCCGTGT
AATACCTCAAG -> ATACCTCAAGT
GTTCTGCATGG -> TTCTGCATGGG
GGAATTATTCG -> GAATTATTCGT
TTTTTGAGTAT -> TTTTGAGTATA
TGGGGTCTAAC -> GGGGTCTAACA
CCTTACACTTC -> CTTACACTTCG
GCGCTCGTTTA -> CGCTCGTTTAA
AGTCGCGGTCT -> GTCGCGGTCTA
ATCTACTCTCG -> TCTACTCTCGG
CCATCAATACG -> CATCAATACGG
AAGCCCCGCTG -> AGCCCCGCTGG
AAGGCTCCCCG -> AGGCTCCCCGA
AGTTTGAGTCT -> GTTTGAGTCTT
CGGACTATTGT -> GGACTATTGTT
ACGGTTTGGAT -> CGGTTTGGATT
TGCTCGGTTAA -> GCTCGGTTAAT
ACCCGCACCGC -> CCCGCACCGCA
AGCATTAGCAG -> GCATTAGCAGC
GCTGAGCGAAC -> CTGAGCGAACA
GAAAGGTAGGT -> AAAGGTAGGTG
CGGTAGGATAA -> GGTAGGATAAT
GAAAGTCAGCA -> AAAGTCAGCAA
TTTTCCACCAC -> TTTCCACCACG
AATCAGATGGT -> ATCAGATGGTC
CCAACACATAA -> CAACACATAAC
AACTTAGTACG -> ACTTAGTACGC
GGGTCCTGGAC -> GGTCCTGGACG
TAAGGAAAGTC -> AAGGAAAGTCA
GCGGCGAAGCA -> CGGCGAAGCAT
TAGTAATAGCT -> AGTAATAGCTG
CATCAATACGG -> ATCAATACGGC
GGAGCTCCTGA -> GAGCTCCTGAT
CTAGCTTGGCA -> TAGCTTGGCAT
ACATACGTGGT -> CATACGTGGTT
GAACGAAATTA -> AACGAAATTAA
CTCCCCTGTCG -> TCCCCTGTCGA
ACTTCATGATT -> CTTCATGATTA
GACGATCCATA -> ACGATCCATAG
TCGAACGCCCG -> CGAACGCCCGA
TCTTTGTTCGG -> CTTTGTTCGGA
TCGTCATCACA -> CGTCATCACAA
TCTCAGCTGGC -> CTCAGCTGGCG
GTGGTTAATGG -> TGGTTAATGGC
TAGCTAGGTGG -> AGCTAGGTGGC
GACTATTGTTA -> ACTATTGTTAA
CGAACGACGGC -> GAACGACGGCA
TTGCGCCTTAG -> TGCGCCTTAGG
GTCGGCGTTAA -> TCGGCGTTAAC
CCCGGAAGAAG -> CCGGAAGAAGA
AAACACAGGGT -> AACACAGGGTG
AGTGAAATGGC -> GTGAAATGGCA
CGACGGCAATC -> GACGGCAATCG
TTTGAGTCTTT -> TTGAGTCTTTG
AAGATCCCCGT -> AGATCCCCGTG
TCCCACATCGA -> CCCACATCGAA
ATTCGCACTGA -> TTCGCACTGAA
TTATCACTCCC -> TATCACTCCCC
CAAGCCGTTTT -> AAGCCGTTTTC
TTAGTTAAGAA -> TAGTTAAGAAA
CAACAGGTTAA -> AACAGGTTAAG
CAGTCTAGCTG -> AGTCTAGCTGA
TTAGCTAGTCG -> TAGCTAGTCGC
CGCTTCTTCGG -> GCTTCTTCGGG
AGTCTAGCTGA -> GTCTAGCTGAG
GTAGCTGTAGT -> TAGCTGTAGTG
GCGAACATAAA -> CGAACATAAAT
TTCGACACGAT -> TCGACACGATT
GTCATAATTAG -> TCATAATTAGA
GAACGGACTAT -> AACGGACTATT
TTCATGATTAG -> TCATGATTAGT
AGGGGTAGGAG -> GGGGTAGGAGT
CCTGTTGCGGC -> CTGTTGCGGCC
AAAAGAACGGA -> AAAGAACGGAC
CTCAGGGATAC -> TCAGGGATACA
GGTGTGCAATC -> GTGTGCAATCA
TAGCAGCTAAC -> AGCAGCTAACC
TAGAGATTCAG -> AGAGATTCAGC
GGATCAAGCTA -> GATCAAGCTAA
ACATAAATGTT -> CATAAATGTTT
AACACAGGGTG -> ACACAGGGTGA
ATGAAAACCAG -> TGAAAACCAGC
GAGCACCGTTG -> AGCACCGTTGC
TTCGTCATCAC -> TCGTCATCACA
TATGTTAAGAG -> ATGTTAAGAGT
CGTACGCGAAT -> GTACGCGAATA
TAACCAAAGGA -> AACCAAAGGAA
TAACTATAGTT -> AACTATAGTTA
AGGGGTGCGAC -> GGGGTGCGACG
CGACACGATTC -> GACACGATTCG
ATCCATAGCTA -> TCCATAGCTAG
GGTGCCTGTTG -> GTGCCTGTTGC
ATGGAACTTAG -> TGGAACTTAGT
GCAGCTAACCT -> CAGCTAACCTA
CTCGGTTAATC -> TCGGTTAATCA
ATGGCAAATAC -> TGGCAAATACC
CATAAATGTTT -> ATAAATGTTTA
GACGTGAGTTC -> ACGTGAGTTCA
GTACGCGAATA -> TACGCGAATAC
AAAATACCAGT -> AAATACCAGTG
GTCATAGAGGC -> TCATAGAGGCC
GTTTAAACACA -> TTTAAACACAG
TTCGCTTCTTC -> TCGCTTCTTCG
CCTTAGGGGCG -> CTTAGGGGCGC
GTCACAATATC -> TCACAATATCC
CCGACTCACTG -> CGACTCACTGA
AGAAAAGAACG -> GAAAAGAACGG
TTGACTGAATC -> TGACTGAATCC
CTCTGCGGTAG -> TCTGCGGTAGG
CGTTAACACTT -> GTTAACACTTG
TGAAAGGGGTA -> GAAAGGGGTAG
TTAGTCAATGG -> TAGTCAATGGT
GTATAGGGGTG -> TATAGGGGTGT
TCGCCACCAGT -> CGCCACCAGTC
GTGCCTGTTGC -> TGCCTGTTGCG
GAAATGGCAAA -> AAATGGCAAAT
CCTGATCATAC -> CTGATCATACT
CAATATCCATT -> AATATCCATTC
TAATTAGAGAT -> AATTAGAGATT
TGAACGAAATT -> GAACGAAATTA
AGAGTAACCAA -> GAGTAACCAAA
AGGTAGGTGCC -> GGTAGGTGCCT
CCCACATCGAA -> CCACATCGAAC
TGCGAATAGCC -> GCGAATAGCCT
CTTGGCATGGG -> TTGGCATGGGT
CGCCCGATCAA -> GCCCGATCAAA
CGACCCGTATA -> GACCCGTATAG
TTCTTCGGGCT -> TCTTCGGGCTC
ATTATAGTACC -> TTATAGTACCC
CGTCATCTGAA -> GTCATCTGAAA
GTGGCGCGATA -> TGGCGCGATAA
GCCAGTCGCCA -> CCAGTCGCCAC
TCCGCGCGTAG -> CCGCGCGTAGT
AGCGAACATAA -> GCGAACATAAA
AGAGATTCAGC -> GAGATTCAGCG
TCTCTCTCAAT -> CTCTCTCAATC
AAGGAATTATT -> AGGAATTATTC
CCCCGGAAGAA -> CCCGGAAGAAG
GAAAGGGGTAG -> AAAGGGGTAGG
ATATGTTAAGA -> TATGTTAAGAG
TTAAGGGTACC -> TAAGGGTACCT
AAAATCGAACC -> AAATCGAACCC
GCCGGCCATCA -> CCGGCCATCAA
TCAAGTTTAGT -> CAAGTTTAGTT
GTCGACCAATT -> TCGACCAATTT
GCGCGTAGTAA -> CGCGTAGTAAT
GAGTTCTGCAT -> AGTTCTGCATG
AATGGCAAATA -> ATGGCAAATAC
CGATAAGCCCA -> GATAAGCCCAG
AGGCTCCCCGA -> GGCTCCCCGAT
CTCATACAGAA -> TCATACAGAAG
TAGTACCCGTC -> AGTACCCGTCG
AATCGAACCCA -> ATCGAACCCAC
ACGTCTGACGA -> CGTCTGACGAT
GGCGAAGCATT -> GCGAAGCATTA
ATACACGGCTT -> TACACGGCTTC
GGAGCACCGTT -> GAGCACCGTTG
GCTGTAGTGCC -> CTGTAGTGCCG
GGTTACGGCTC -> GTTACGGCTCT
GCCCGATCAAA -> CCCGATCAAAT
ACAAGAAAAGA -> CAAGAAAAGAA
GAGGACATTCC -> AGGACATTCCT
GCATTAGCAGC -> CATTAGCAGCT
TATTCGCACTG -> ATTCGCACTGA
GCGGTCTACAA -> CGGTCTACAAC
GATCAAGCTAA -> ATCAAGCTAAT
CCTGTTGTCAT -> CTGTTGTCATT
ACCGGATCAAG -> CCGGATCAAGC
CATCACAAGCA -> ATCACAAGCAG
GTCAGCAAAAG -> TCAGCAAAAGG
AGGCCCCCGGA -> GGCCCCCGGAA
GAGTCTTTGTT -> AGTCTTTGTTC
CATGAACGAAA -> ATGAACGAAAT
GTGTGCAATCA -> TGTGCAATCAG
TGGAACTTAGT -> GGAACTTAGTA
CTGAAAGGGGT -> TGAAAGGGGTA
AGAGTCCCACC -> GAGTCCCACCC
TCAATACGGCG -> CAATACGGCGT
CATGAAAACCA -> ATGAAAACCAG
GGGTGCGACGC -> GGTGCGACGCC
AGGACATTCCT -> GGACATTCCTT
GGATATGTTAA -> GATATGTTAAG
TCCTGATCATA -> CCTGATCATAC
TCCCACCCGCA -> CCCACCCGCAC
TCGGAGAGTAA -> CGGAGAGTAAC
GATAATCATGT -> ATAATCATGTG
CTCTCTCAATC -> TCTCTCAATCA
ATAATCATGTG -> TAATCATGTGG
TAGTTGAAGAT -> AGTTGAAGATT
GTCTATTCGCA -> TCTATTCGCAC
GAAAAAGTCTA -> AAAAAGTCTAG
