TTCCGGAGCCA -> TCCGGAGCCAA
CTCGTATTTTG -> TCGTATTTTGT
GTGAAAGAACC -> TGAAAGAACCT
ACGAAGTCACG -> CGAAGTCACGG
CGACAAATTTC -> GACAAATTTCT
GTACCGCCAAA -> TACCGCCAAAC
GCCAACAAGGC -> CCAACAAGGCT
GCTCCACGGAA -> CTCCACGGAAG
ATGGATATCTT -> TGGATATCTTG
GTGAGTCCTTG -> TGAGTCCTTGT
CTGGGGATCCA -> TGGGGATCCAA
TAACTGTCAGA -> AACTGTCAGAG
TAACCCACCTC -> AACCCACCTCG
ATCTGGGGATC -> TCTGGGGATCC
AACTCGTTCGG -> ACTCGTTCGGC
GGATCATGTTA -> GATCATGTTAG
TCATTTAATCA -> CATTTAATCAA
CTTAGCTTGTA -> TTAGCTTGTAA
CAACGCTGTCC -> AACGCTGTCCT
TTTGAAATGGG -> TTGAAATGGGA
CACGGGTCTAG -> ACGGGTCTAGC
GGCGAACACCT -> GCGAACACCTG
TGATATTGCCG -> GATATTGCCGT
ACAGCCCAGAA -> CAGCCCAGAAT
ACGACGGTCCG -> CGACGGTCCGT
CGCTCTGTGAT -> GCTCTGTGATC
ACTTTGCGAGC -> CTTTGCGAGCG
AGGACTGTCAG -> GGACTGTCAGG
AATTAACTAGA -> ATTAACTAGAA
TTCGTCTAGGA -> TCGTCTAGGAC
CACGACCGATG -> ACGACCGATGA
CGCGAGCATGG -> GCGAGCATGGG
GGCTTACACCT -> GCTTACACCTA
CGTGAAACACT -> GTGAAACACTT
GTCAGGCTTCC -> TCAGGCTTCCT
AATCAACGAAA -> ATCAACGAAAC
CTAGGGATTTG -> TAGGGATTTGA
GTCTGCGACAG -> TCTGCGACAGC
GTGAATGAACC -> TGAATGAACCG
CGATGGCGAAG -> GATGGCGAAGT
AGCGGCTCCAC -> GCGGCTCCACG
GGCGCTGATAG -> GCGCTGATAGC
ACGGATCCGAA -> CGGATCCGAAA
CCACTACCCGC -> CACTACCCGCA
AGTCTCCCACA -> GTCTCCCACAG
GATCTTCGCCT -> ATCTTCGCCTC
CATAATACAGC -> ATAATACAGCT
GTGGCGCCTAT -> TGGCGCCTATT
CCAGAGAGACT -> CAGAGAGACTA
AAATTTCTGAT -> AATTTCTGATC
GACACAATACC -> ACACAATACCG
AGCCTATGGAT -> GCCTATGGATA
AACGCTCTGGC -> ACGCTCTGGCC
CGCGTTATCTG -> GCGTTATCTGG
CATGTTAGAAG -> ATGTTAGAAGC
GGATGAGTCCT -> GATGAGTCCTA
AGGATGGACTC -> GGATGGACTCC
ACTCCGACGGT -> CTCCGACGGTC
ACATGTGTTCT -> CATGTGTTCTC
TTCACCATGAC -> TCACCATGACC
CGGTCCGTCAT -> GGTCCGTCATG
CCGGGTATCCG -> CGGGTATCCGA
CCTTTTTGCTA -> CTTTTTGCTAA
CACAATACCGC -> ACAATACCGCA
AAGGCAGCGTT -> AGGCAGCGTTA
CTAGGACATCT -> TAGGACATCTT
AGAGACTAATG -> GAGACTAATGC
CCTATGCTCGA -> CTATGCTCGAG
TATGCTCGAGA -> ATGCTCGAGAT
CGCTCTGGCCA -> GCTCTGGCCAC
CACTTCTGGAC -> ACTTCTGGACA
GCGCTGATAGC -> CGCTGATAGCC
GCCTCATGCTA -> CCTCATGCTAC
GCCGTTGTTGT -> CCGTTGTTGTA
TAATTCACGAC -> AATTCACGACC
ATGCTCGAGAT -> TGCTCGAGATA
GACAGCCGGCG -> ACAGCCGGCGC
CGTTTTATGAC -> GTTTTATGACT
GAATTTTTCAC -> AATTTTTCACC
ATACTGTTGTC -> TACTGTTGTCT
GTTGTGTCTAA -> TTGTGTCTAAT
TGCGTTAGGAA -> GCGTTAGGAAG
ACCTCGCTACG -> CCTCGCTACGA
GGGTCCCGGCG -> GGTCCCGGCGC
TGCGTGACCAG -> GCGTGACCAGA
CTACGTCCGGG -> TACGTCCGGGC
ACAATCGGGTT -> CAATCGGGTTG
GATAGCCTATG -> ATAGCCTATGG
AGTAGAAGGAT -> GTAGAAGGATT
GCGACGAAAAA -> CGACGAAAAAA
ATATTTCTAAC -> TATTTCTAACT
GTCCATCGGGT -> TCCATCGGGTT
ACAGCCTTCGT -> CAGCCTTCGTC
CTGATAGCCTA -> TGATAGCCTAT
CGTATACGGAA -> GTATACGGAAC
CTTGTGCCCAT -> TTGTGCCCATC
CACCATGACCG -> ACCATGACCGA
GTTGTTAGGGC -> TTGTTAGGGCG
TGCGTTGAATG -> GCGTTGAATGA
TCCCTATGCAC -> CCCTATGCACG
ACTACCCGCAT -> CTACCCGCATC
TACCGCACATG -> ACCGCACATGC
GGATCCAAGAA -> GATCCAAGAAT
ACAATACCGCA -> CAATACCGCAC
CACATAGTAAT -> ACATAGTAATC
TCGAGATACTG -> CGAGATACTGT
TGATCAGTAAC -> GATCAGTAACA
CCCGCGAACAA -> CCGCGAACAAG
TCTTGTGTACG -> CTTGTGTACGA
GAGGCGGCGAA -> AGGCGGCGAAC
GGCGCCGGACT -> GCGCCGGACTT
TGCTTATACGT -> GCTTATACGTC
CTAATGCTACA -> TAATGCTACAC
TGACCGACATG -> GACCGACATGT
ATGGGCACGGG -> TGGGCACGGGT
TCGTATTTTGT -> CGTATTTTGTC
CACCATGATAA -> ACCATGATAAG
AGAAGGATTCG -> GAAGGATTCGA
CATGTGGCGCC -> ATGTGGCGCCT
ATATTCGTACT -> TATTCGTACTG
GGCGGCGAACA -> GCGGCGAACAC
TTTTGTCGTTT -> TTTGTCGTTTT
TAATCAATGAA -> AATCAATGAAC
TGATGCCTGGG -> GATGCCTGGGT
GATTCCCCCAG -> ATTCCCCCAGG
GGCCACCCGCG -> GCCACCCGCGA
CGAGCCACGGT -> GAGCCACGGTA
GCGAGCGGCTC -> CGAGCGGCTCC
TAGAAGGGCGG -> AGAAGGGCGGA
AAAGAACCTCC -> AAGAACCTCCA
CATCCATATGA -> ATCCATATGAT
GTGGCCTGCCC -> TGGCCTGCCCT
GTCCATCTCAA -> TCCATCTCAAA
CGGGTTGGTGC -> GGGTTGGTGCA
GGAAGGACACT -> GAAGGACACTA
GCTACGAAAAC -> CTACGAAAACA
CACTAAGTCTG -> ACTAAGTCTGG
TCACTATGTGG -> CACTATGTGGC
GATATTGCCGT -> ATATTGCCGTT
CGAACTTCAGC -> GAACTTCAGCC
TATACTCATGA -> ATACTCATGAT
ACATGCGTTGG -> CATGCGTTGGG
ATCGGTTGACA -> TCGGTTGACAT
GGCCGTGGACT -> GCCGTGGACTA
ATTCACGACCG -> TTCACGACCGA
TTTCCATCCAT -> TTCCATCCATA
TAGGAAGATCT -> AGGAAGATCTA
GGTGATTTAAT -> GTGATTTAATC
TTGCTAAACGA -> TGCTAAACGAA
ACTTTTTATTC -> CTTTTTATTCT
AGATCTACGTC -> GATCTACGTCC
TATATTTCTAA -> ATATTTCTAAC
CGGATGCGTTG -> GGATGCGTTGA
TGTCCTGAACA -> GTCCTGAACAC
GCCGGCGCTGA -> CCGGCGCTGAT
GTTATGAGTAT -> TTATGAGTATA
GTGATTTAATC -> TGATTTAATCT
AACGATGGCGA -> ACGATGGCGAA
TGTCTAATCGC -> GTCTAATCGCG
AGTGTTCAGTT -> GTGTTCAGTTT
CCTGGGTGAGT -> CTGGGTGAGTC
AAGGATTCGAC -> AGGATTCGACA
AATGATTCCCC -> ATGATTCCCCC
CCGACATGTGT -> CGACATGTGTT
TCAGTTTCTCT -> CAGTTTCTCTG
ACGTTAATTCA -> CGTTAATTCAC
CTGCGACAGCC -> TGCGACAGCCG
AGAGGTCGTCC -> GAGGTCGTCCA
CAATGAACAGT -> AATGAACAGTA
TTCACCTTTTT -> TCACCTTTTTG
TGTCAGGCTTC -> GTCAGGCTTCC
GTCCTAAACCG -> TCCTAAACCGG
TTTTCCATCCA -> TTTCCATCCAT
ACATAGTAATC -> CATAGTAATCC
CAAGAATCACT -> AAGAATCACTT
AAAGGCCGTGA -> AAGGCCGTGAA
TCGGGTTGGTG -> CGGGTTGGTGC
TAGATATAATC -> AGATATAATCA
ACGGAAGGACA -> CGGAAGGACAC
CGAAGTAATTT -> GAAGTAATTTT
ACTCGTTCGGC -> CTCGTTCGGCC
ACGGACTGCGT -> CGGACTGCGTT
TGAACCGGAGC -> GAACCGGAGCT
CGCATTTAACT -> GCATTTAACTT
TGCCCTTTTCC -> GCCCTTTTCCA
TAGAGGCGGCG -> AGAGGCGGCGA
GCTAAACGAAG -> CTAAACGAAGA
TATAATCAACG -> ATAATCAACGA
TCTCTTATATT -> CTCTTATATTC
ACGAGGTGAGT -> CGAGGTGAGTC
CGAACACCTGT -> GAACACCTGTA
CTATGGATATC -> TATGGATATCT
TCATGTTAGAA -> CATGTTAGAAG
AATAAGTCACT -> ATAAGTCACTA
TTCAGGACACA -> TCAGGACACAA
ATGATGCCTGG -> TGATGCCTGGG
TGGATGGTGGG -> GGATGGTGGGA
GGAGGATGGAC -> GAGGATGGACT
GGGCATAATAC -> GGCATAATACA
GGTTCTTGGTG -> GTTCTTGGTGA
TCTAGCACAAT -> CTAGCACAATC
ACCATGACCGA -> CCATGACCGAC
TTAATCTGGAC -> TAATCTGGACT
TGTGTACGACG -> GTGTACGACGG
ACCGACATGTG -> CCGACATGTGT
TAATCGCGAGC -> AATCGCGAGCA
GGCAGTCCATC -> GCAGTCCATCT
GCTCTGAATTA -> CTCTGAATTAA
AAGAAGAGGTT -> AGAAGAGGTTC
CGTGAATGAAC -> GTGAATGAACC
GGCATTGTCTT -> GCATTGTCTTA
TATCTTGTGTA -> ATCTTGTGTAC
CGGCGAACACC -> GGCGAACACCT
CAACTCCGTTT -> AACTCCGTTTT
AGTTTCTCTGG -> GTTTCTCTGGC
AGAAGCTCTGA -> GAAGCTCTGAA
ATTAACTAGAA -> TTAACTAGAAG
CAAGTACTAAG -> AAGTACTAAGA
GTACCCTGCGT -> TACCCTGCGTG
GCGTGACCAGA -> CGTGACCAGAG
CATGATCCATT -> ATGATCCATTC
TCGTTCGGCCA -> CGTTCGGCCAC
AGTACGAGGTG -> GTACGAGGTGA
CGCGTATACGG -> GCGTATACGGA
TACGAAAACAA -> ACGAAAACAAT
AGTCCATCTCA -> GTCCATCTCAA
AACGAAGTCAC -> ACGAAGTCACG
ATCGGGTTTTG -> TCGGGTTTTGT
CTGATCGGTAC -> TGATCGGTACC
CGCTACGAAAA -> GCTACGAAAAC
TGGGGGGCTGG -> GGGGGGCTGGA
CTGCTTATACG -> TGCTTATACGT
TGCTAAACGAA -> GCTAAACGAAG
ACAAGGCTGTG -> CAAGGCTGTGT
GGAGCTCCGGG -> GAGCTCCGGGT
TATACGTCATT -> ATACGTCATTT
TCGTCCATCGA -> CGTCCATCGAA
GTTGTGGGCAT -> TTGTGGGCATA
ATTTGAATGAT -> TTTGAATGATT
GGTCGTCCATC -> GTCGTCCATCG
CAGCCTTCGTC -> AGCCTTCGTCT
GTAACAACTCC -> TAACAACTCCG
TCCGTTTTATG -> CCGTTTTATGA
TACCGCCAAAC -> ACCGCCAAACA
ATGACTTGCGT -> TGACTTGCGTG
ATAATACAGCT -> TAATACAGCTG
CCGCGAACAAG -> CGCGAACAAGA
GAGTGAAAGAA -> AGTGAAAGAAC
CTTGTTTCTGC -> TTGTTTCTGCT
TCAACGAAACG -> CAACGAAACGC
CGAAAAAATTA -> GAAAAAATTAA
GTGCCTCATGC -> TGCCTCATGCT
GGCGGAAGAAA -> GCGGAAGAAAG
ACCTACTCCGA -> CCTACTCCGAC
TATTCTACCAC -> ATTCTACCACT
AAACGTTGTGG -> AACGTTGTGGG
ATGTTAGAAGC -> TGTTAGAAGCT
TAGGGAGCTCC -> AGGGAGCTCCG
CATGCTACTGC -> ATGCTACTGCA
TGGAGGATGGA -> GGAGGATGGAC
ACCCGCATCTT -> CCCGCATCTTA
TATGAGTATAC -> ATGAGTATACT
AAAACGTTGTG -> AAACGTTGTGG
ACTGTCAGGCT -> CTGTCAGGCTT
TGGCCTGCCCT -> GGCCTGCCCTT
CTTTGCGAGCG -> TTTGCGAGCGG
CGGGTCATGAC -> GGGTCATGACG
GGTAGAGGCGG -> GTAGAGGCGGC
TTCTGGACATC -> TCTGGACATCT
ACATCGACACT -> CATCGACACTC
TGATCGGTACC -> GATCGGTACCC
CACTCATGCGT -> ACTCATGCGTA
CACGGATCCGA -> ACGGATCCGAA
CTCCTATGCTC -> TCCTATGCTCG
GAAGGACACTA -> AAGGACACTAA
GGTGAGTCCTT -> GTGAGTCCTTG
TCATGTGGCGC -> CATGTGGCGCC
GTTAGACTGGA -> TTAGACTGGAA
ACTTTGAAATG -> CTTTGAAATGG
GGCTGTGTGGG -> GCTGTGTGGGC
TGTCACATAGT -> GTCACATAGTA
CAAAACGTTGT -> AAAACGTTGTG
CTAATCAGTCC -> TAATCAGTCCA
TAACAACTCCG -> AACAACTCCGT
GCCTATTAAGG -> CCTATTAAGGC
TAATCAACGAA -> AATCAACGAAA
CTTCAGTGTCC -> TTCAGTGTCCC
TTCTACCACTT -> TCTACCACTTG
AGACGCCGCTC -> GACGCCGCTCT
CCCATGTTAGA -> CCATGTTAGAC
GTTGGGAAATT -> TTGGGAAATTC
AACTGTGGGTC -> ACTGTGGGTCC
CAAATTTCTGA -> AAATTTCTGAT
CCGGCCGTGGA -> CGGCCGTGGAC
GATCCATTCGC -> ATCCATTCGCG
AGGACACTAAG -> GGACACTAAGT
ACCTGTAACTC -> CCTGTAACTCC
GATGTTGAAAA -> ATGTTGAAAAG
CCATCTCAAAA -> CATCTCAAAAC
ACATCTTAGTA -> CATCTTAGTAG
AGTCTGCGACA -> GTCTGCGACAG
GATCTACGTCC -> ATCTACGTCCG
TTTCTGATCGG -> TTCTGATCGGT
TCTCGGGTCAT -> CTCGGGTCATG
GGGCACGGGTC -> GGCACGGGTCT
AAATTAATAAG -> AATTAATAAGT
TAATCAGTCCA -> AATCAGTCCAT
ACTAATGCTAC -> CTAATGCTACA
CCAGGACTGTC -> CAGGACTGTCA
GCCCATTTCGA -> CCCATTTCGAG
ATTCTACCACT -> TTCTACCACTT
CACCTACTCCG -> ACCTACTCCGA
GTGTCTAATCA -> TGTCTAATCAG
TATGGATATCT -> ATGGATATCTT
CTGTCAGAGTG -> TGTCAGAGTGT
GGTACGAAGTA -> GTACGAAGTAA
CATGTTAGACT -> ATGTTAGACTG
AGAGGTTCTTG -> GAGGTTCTTGG
GGTTTTGTCGT -> GTTTTGTCGTA
TTTAACACCAT -> TTAACACCATG
CTTTAACTGTC -> TTTAACTGTCA
GAATGTCACAT -> AATGTCACATA
GGTCTAGCACA -> GTCTAGCACAA
CATCTGGGGAT -> ATCTGGGGATC
AGGGATTTGAA -> GGGATTTGAAT
ATTCCCTATGC -> TTCCCTATGCA
CACTATGTGGC -> ACTATGTGGCG
GATAAGCGCCT -> ATAAGCGCCTT
TCGAGCGCGTT -> CGAGCGCGTTA
ATATTCGGATG -> TATTCGGATGC
CTCAAAACGTT -> TCAAAACGTTG
ATGTCACATAG -> TGTCACATAGT
ACGAAACGCGG -> CGAAACGCGGG
AACTCAGTGGA -> ACTCAGTGGAT
CATTTAACACC -> ATTTAACACCA
CCGTGGACTAG -> CGTGGACTAGG
GGACACAATAC -> GACACAATACC
AACTTCAGCCC -> ACTTCAGCCCT
CGCCGGACTTT -> GCCGGACTTTG
CTTAGTAGACG -> TTAGTAGACGC
CAGCTGGAGAA -> AGCTGGAGAAC
CAACAAGGCTG -> AACAAGGCTGT
GTGTACGACGG -> TGTACGACGGT
TGAGTATACTC -> GAGTATACTCA
GGCTGGAGCAC -> GCTGGAGCACA
CCCTTCAGTGT -> CCTTCAGTGTC
GCGTTGAATGA -> CGTTGAATGAT
GAAGCTCTGAA -> AAGCTCTGAAT
AGGTTCTTGGT -> GGTTCTTGGTG
AGGGCGGAAGA -> GGGCGGAAGAA
AAACCGGGGGT -> AACCGGGGGTA
TTCCCCCAGGA -> TCCCCCAGGAT
TTGTTGTAACT -> TGTTGTAACTC
TATGTGGCGGG -> ATGTGGCGGGT
TTGCGAGCGGC -> TGCGAGCGGCT
GGATTCGACAA -> GATTCGACAAA
CTATGTGGCGG -> TATGTGGCGGG
ACGAAGTAATT -> CGAAGTAATTT
AGAACGATGGC -> GAACGATGGCG
TTCGGCCACCC -> TCGGCCACCCG
CAGTGTCCCCA -> AGTGTCCCCAT
GTAACTAACCC -> TAACTAACCCA
TTAGATATAAT -> TAGATATAATC
AATACAGAGTG -> ATACAGAGTGA
GAGCTTGTGCC -> AGCTTGTGCCC
GCCAAACAACG -> CCAAACAACGC
AATCAGTCCAT -> ATCAGTCCATC
GTATCCGAAAG -> TATCCGAAAGC
CTACTTTGAAA -> TACTTTGAAAT
GGTATCCGAAA -> GTATCCGAAAG
AACAACGCTGT -> ACAACGCTGTC
CAGTCCATCGG -> AGTCCATCGGG
GATCCAAGAAT -> ATCCAAGAATC
AACGTTAATTC -> ACGTTAATTCA
ATGATAAGCGC -> TGATAAGCGCC
CTAGAAGGGCG -> TAGAAGGGCGG
CGGTACGAAGT -> GGTACGAAGTA
ACTATGTGGCG -> CTATGTGGCGG
TAGACTGGAAT -> AGACTGGAATA
ATGAGTCCTAA -> TGAGTCCTAAA
TAGAAGGATTC -> AGAAGGATTCG
CCGGCGCTGAT -> CGGCGCTGATA
GGTCGACCGGC -> GTCGACCGGCC
CGTACTGATAG -> GTACTGATAGT
TGGACATCTTA -> GGACATCTTAG
GGGTTGGTGCA -> GGTTGGTGCAT
GCATTGTCTTA -> CATTGTCTTAC
AATCACTTGGG -> ATCACTTGGGG
TTCTTGGTGAT -> TCTTGGTGATT
CTCTGTGCCTC -> TCTGTGCCTCA
CCATGACCGAC -> CATGACCGACA
TCCACGGAAGG -> CCACGGAAGGA
GACTTTGCGAG -> ACTTTGCGAGC
CCTTCAGTGTC -> CTTCAGTGTCC
CAGTTTCTCTG -> AGTTTCTCTGG
CCCAGGATGGA -> CCAGGATGGAG
CCGAAACTGTG -> CGAAACTGTGG
TGTCCCCATCA -> GTCCCCATCAC
TGTGGGTCCCG -> GTGGGTCCCGG
CTGTTGTCTAA -> TGTTGTCTAAT
TAGAAGCTCTG -> AGAAGCTCTGA
CCCATTTCGAG -> CCATTTCGAGC
TAACAAGTACT -> AACAAGTACTA
ATGCACGCCTA -> TGCACGCCTAG
GTCTAGCACAA -> TCTAGCACAAT
ATGAACCGGAG -> TGAACCGGAGC
TTTTTATTCTA -> TTTTATTCTAC
TGTGTTCTCGA -> GTGTTCTCGAA
CTGGAATACAG -> TGGAATACAGA
GACTTTTTATT -> ACTTTTTATTC
AAGTCACGGAC -> AGTCACGGACT
GCCTGCCCTTT -> CCTGCCCTTTT
GACACTAAGTC -> ACACTAAGTCT
AGCGCCTTCCG -> GCGCCTTCCGG
GCGCCTTCCGG -> CGCCTTCCGGA
CCACCTCGCTA -> CACCTCGCTAC
TCTTAGTAGAC -> CTTAGTAGACG
TTACACCTACT -> TACACCTACTC
CCGACACAACA -> CGACACAACAC
ACTTGGGGGGC -> CTTGGGGGGCT
CTGGAGCACAT -> TGGAGCACATC
AGTCCATCGGG -> GTCCATCGGGT
CCGTTTTATGA -> CGTTTTATGAC
TCGCTACGAAA -> CGCTACGAAAA
AGTGTCCCCAT -> GTGTCCCCATC
TGTAACTCCTA -> GTAACTCCTAT
CGCCTATTAAG -> GCCTATTAAGG
CACCGTAGTGC -> ACCGTAGTGCC
TATCTGGATCA -> ATCTGGATCAT
ACTCCGTTTTA -> CTCCGTTTTAT
AGCCAACAAGG -> GCCAACAAGGC
CCGCCAAACAA -> CGCCAAACAAC
ACTAAGAGGTC -> CTAAGAGGTCG
CGCCTTCCGGA -> GCCTTCCGGAG
TGTATCATTCA -> GTATCATTCAC
AGCCGGCGCTG -> GCCGGCGCTGA
CGCCTCTCTTA -> GCCTCTCTTAT
AATGGTTACAG -> ATGGTTACAGC
GGATGGTGGGA -> GATGGTGGGAC
CTTACACCTAC -> TTACACCTACT
ACCATGATAAG -> CCATGATAAGC
TCTTCGCCTCT -> CTTCGCCTCTC
TTTTCAGGACA -> TTTCAGGACAC
TCGGGTTTTGT -> CGGGTTTTGTC
CAAATATTCGT -> AAATATTCGTA
AAACGAAGTCA -> AACGAAGTCAC
TGGGACAAATA -> GGGACAAATAT
GGAACCAATAC -> GAACCAATACG
CACCCGCGAAC -> ACCCGCGAACA
ATACTCATGAT -> TACTCATGATC
GCTCATTTAAT -> CTCATTTAATC
GGCAAATCGGT -> GCAAATCGGTT
GGTTGACATTG -> GTTGACATTGT
CGGCGCATTTA -> GGCGCATTTAA
CCCGGCGCATT -> CCGGCGCATTT
TCGACAAATTT -> CGACAAATTTC
GGTCCCGGCGC -> GTCCCGGCGCA
AACTTTCTCGG -> ACTTTCTCGGG
CATCTTAGTAG -> ATCTTAGTAGA
CCATGTTAGAC -> CATGTTAGACT
GCTTGTGCCCA -> CTTGTGCCCAT
TAACTCAGTGG -> AACTCAGTGGA
AAGCGTATATT -> AGCGTATATTT
ATTTTGTCGTT -> TTTTGTCGTTT
TCAGGACACAA -> CAGGACACAAT
GGGACAAATAT -> GGACAAATATT
AACTAGAAGGG -> ACTAGAAGGGC
TTAATCAATGA -> TAATCAATGAA
GTATTTTGTCG -> TATTTTGTCGT
TTGTCTTACAG -> TGTCTTACAGG
AACAGCCTTCG -> ACAGCCTTCGT
GAGTCCTTGTT -> AGTCCTTGTTT
ACAAATTTCTG -> CAAATTTCTGA
AACACCATGAT -> ACACCATGATA
AGTAGACGCCG -> GTAGACGCCGC
TGTTCTCGAAC -> GTTCTCGAACT
CTGAAAACTCG -> TGAAAACTCGT
GACTGTCAGGC -> ACTGTCAGGCT
AGTGGATGGTG -> GTGGATGGTGG
ATCCATTCGCG -> TCCATTCGCGT
TAATACAGCTG -> AATACAGCTGG
TGACTTGCGTG -> GACTTGCGTGA
GAGCCAACAAG -> AGCCAACAAGG
TTTTGGCTTAC -> TTTGGCTTACA
AGTGATATTGC -> GTGATATTGCC
ACGAATTTTTC -> CGAATTTTTCA
GTGATATTGCC -> TGATATTGCCG
ATAAGCGCCTT -> TAAGCGCCTTC
ACCCGACACAA -> CCCGACACAAC
AGCCTTCGTCT -> GCCTTCGTCTA
ACTTGGCTCAT -> CTTGGCTCATT
GATCAGTAACA -> ATCAGTAACAA
GCGAACAAGAA -> CGAACAAGAAC
GCGACAGCCGG -> CGACAGCCGGC
AGTAATCCAGT -> GTAATCCAGTC
TAAGTCTGGCG -> AAGTCTGGCGA
TGTTGTAACTC -> GTTGTAACTCA
AAGAGGTTCTT -> AGAGGTTCTTG
GACTACTTTGA -> ACTACTTTGAA
GAGTGTTCAGT -> AGTGTTCAGTT
GTTGACATTGT -> TTGACATTGTA
AGCTGGAGAAC -> GCTGGAGAACG
TGGAGCACATC -> GGAGCACATCG
GTCTAATCAGT -> TCTAATCAGTC
GCCTTCGTCTA -> CCTTCGTCTAG
TGAATGATGTT -> GAATGATGTTG
CTCTGAATTAA -> TCTGAATTAAC
CCATTTCGAGC -> CATTTCGAGCG
AACTTTAACTG -> ACTTTAACTGT
CGAAAGCGTAT -> GAAAGCGTATA
CTAGGGAGCTC -> TAGGGAGCTCC
CAACACAGCCC -> AACACAGCCCA
GCATGTTGTGT -> CATGTTGTGTC
ATATCTTGTGT -> TATCTTGTGTA
GACTGGAATAC -> ACTGGAATACA
GGGATCCAAGA -> GGATCCAAGAA
CTCGTTCGGCC -> TCGTTCGGCCA
TAGGGATTTGA -> AGGGATTTGAA
TTCGAGCGCGT -> TCGAGCGCGTT
GTAGTTGTTAG -> TAGTTGTTAGG
GGGTGAGTCCT -> GGTGAGTCCTT
GATGGACTCCC -> ATGGACTCCCA
CTACCACTTGG -> TACCACTTGGC
AATATTCGTAC -> ATATTCGTACT
GAACGATGGCG -> AACGATGGCGA
TGATAGTGCTG -> GATAGTGCTGA
TCTGGACATCT -> CTGGACATCTT
CCCCCAGGATG -> CCCCAGGATGG
AGATATAATCA -> GATATAATCAA
AGGTCGTCCAT -> GGTCGTCCATC
AAAGCGTATAT -> AAGCGTATATT
CAGCCCTTCAG -> AGCCCTTCAGT
TAAGTCACTAT -> AAGTCACTATG
ATCCAGTCTGC -> TCCAGTCTGCG
TGAATTAACTA -> GAATTAACTAG
CATGGGCACGG -> ATGGGCACGGG
AGTCACTATGT -> GTCACTATGTG
GAGCGCGTTAT -> AGCGCGTTATC
GCCCTTTTCCA -> CCCTTTTCCAT
AAGACTACTTT -> AGACTACTTTG
ATGCTACTGCA -> TGCTACTGCAC
TCAAAACGTTG -> CAAAACGTTGT
TACCCGCATCT -> ACCCGCATCTT
ACACAACACAG -> CACAACACAGC
AAAAAATTAAT -> AAAAATTAATA
TGAAAGAACCT -> GAAAGAACCTC
GTTGTCTAATC -> TTGTCTAATCG
ACTGCGTTAGG -> CTGCGTTAGGA
TAGGACATCTT -> AGGACATCTTA
CGACCGGCCGT -> GACCGGCCGTG
CGCGGGTGGCC -> GCGGGTGGCCT
GATTCGACAAA -> ATTCGACAAAT
AACGAAGACTA -> ACGAAGACTAC
ATCGGGTTGGT -> TCGGGTTGGTG
CTACTGCACTA -> TACTGCACTAG
GAAAGCGTATA -> AAAGCGTATAT
CCACTTGGCTC -> CACTTGGCTCA
CAGGACACAAT -> AGGACACAATA
GTTACAGCACG -> TTACAGCACGG
GAACCGGAGCT -> AACCGGAGCTT
GGACTAGGGAG -> GACTAGGGAGC
TCTGATCGGTA -> CTGATCGGTAC
GCACATGCGTT -> CACATGCGTTG
CGACCGATGAT -> GACCGATGATT
GCCTAGGGATT -> CCTAGGGATTT
CACAGCCCAGA -> ACAGCCCAGAA
AGCTTGTGCCC -> GCTTGTGCCCA
CTCTCTTATAT -> TCTCTTATATT
AGAATAAGAAG -> GAATAAGAAGA
GTGCCCATTTC -> TGCCCATTTCG
CGTTAGGAAGA -> GTTAGGAAGAT
GGGAGCTCCGG -> GGAGCTCCGGG
CGGAACCAATA -> GGAACCAATAC
GTGCCCATCTG -> TGCCCATCTGG
CAGAGTGAAAG -> AGAGTGAAAGA
CGGTTGACATT -> GGTTGACATTG
ACTGTGGGTCC -> CTGTGGGTCCC
GCTCGAGATAC -> CTCGAGATACT
TTATGAGTATA -> TATGAGTATAC
TACTGTTGTCT -> ACTGTTGTCTA
CTTGGTGATTT -> TTGGTGATTTA
GTCGACCGGCC -> TCGACCGGCCG
TCTGCGACAGC -> CTGCGACAGCC
GACAAATTTCT -> ACAAATTTCTG
TCTAGGACATC -> CTAGGACATCT
TGTTGTGTCTA -> GTTGTGTCTAA
GTCGTAACTAA -> TCGTAACTAAC
CGGGTATCCGA -> GGGTATCCGAA
GGCAGCGTTAG -> GCAGCGTTAGA
TGGAGAACGTT -> GGAGAACGTTA
ACCGCCAAACA -> CCGCCAAACAA
ATCTTCGCCTC -> TCTTCGCCTCT
AACTCCGTTTT -> ACTCCGTTTTA
AGAAAGGCCGT -> GAAAGGCCGTG
TATTGCCGTTG -> ATTGCCGTTGT
TCACCATGACC -> CACCATGACCG
CCGGGCCTCGT -> CGGGCCTCGTA
CACAACACAGC -> ACAACACAGCC
ACAAGAACGAT -> CAAGAACGATG
ACAACACAGCC -> CAACACAGCCC
ATTACTCTGTG -> TTACTCTGTGC
ATGATGTTGAA -> TGATGTTGAAA
TCTGCTTATAC -> CTGCTTATACG
GGAGCCAACAA -> GAGCCAACAAG
AACTAACCCAC -> ACTAACCCACC
GACGGTCCGTC -> ACGGTCCGTCA
TGACGAGCCAC -> GACGAGCCACG
ACGGTACGAAG -> CGGTACGAAGT
CCAGTCTGCGA -> CAGTCTGCGAC
AAACGAAGACT -> AACGAAGACTA
ATCAACGAAAC -> TCAACGAAACG
TGGACTAGGGA -> GGACTAGGGAG
GGGGGCTGGAG -> GGGGCTGGAGC
TCAGTGTCCCC -> CAGTGTCCCCA
CAAGAACGATG -> AAGAACGATGG
GGGCCTCGTAT -> GGCCTCGTATT
TTTTTGCTAAA -> TTTTGCTAAAC
TCTGGCGACGA -> CTGGCGACGAA
AAGAAAGGCCG -> AGAAAGGCCGT
TGGACTTTTTA -> GGACTTTTTAT
CGCTGATAGCC -> GCTGATAGCCT
TGCTACACTGA -> GCTACACTGAT
GGAGAACGTTA -> GAGAACGTTAA
AATACGAATTT -> ATACGAATTTT
ATAGTGCTGAA -> TAGTGCTGAAA
ATGATCCATTC -> TGATCCATTCG
TGATAAGCGCC -> GATAAGCGCCT
AATCGGGTTGG -> ATCGGGTTGGT
TTTTTGGCTTA -> TTTTGGCTTAC
AAATGGGATGA -> AATGGGATGAG
CCGACGGTCGA -> CGACGGTCGAC
GACATTGTATC -> ACATTGTATCA
CTCCCATGTTA -> TCCCATGTTAG
ACGAGCCACGG -> CGAGCCACGGT
TGGACTCCCAT -> GGACTCCCATG
GCATCTTAGCT -> CATCTTAGCTT
GTTAGATATAA -> TTAGATATAAT
GGTGGCCTGCC -> GTGGCCTGCCC
GAATCACTTGG -> AATCACTTGGG
CGTAGTTGTTA -> GTAGTTGTTAG
TGGCGACGAAA -> GGCGACGAAAA
CAGCGTTAGAT -> AGCGTTAGATA
CATCTTAGGCA -> ATCTTAGGCAG
GGATGGACTCC -> GATGGACTCCC
CGGAGCCAACA -> GGAGCCAACAA
AGGATGGAGGA -> GGATGGAGGAT
TGCGAGCGGCT -> GCGAGCGGCTC
TGCGACAGCCG -> GCGACAGCCGG
GTAATCCAGTC -> TAATCCAGTCT
TTCTCTGGCAT -> TCTCTGGCATT
CAAATCGGTTG -> AAATCGGTTGA
GTCTAGGACAT -> TCTAGGACATC
TATGCACGCCT -> ATGCACGCCTA
AGTCCTAAACC -> GTCCTAAACCG
AGTGAAAGAAC -> GTGAAAGAACC
GTTCTTGGTGA -> TTCTTGGTGAT
ATCGCGAGCAT -> TCGCGAGCATG
CTCGGGTCATG -> TCGGGTCATGA
TTATTCTACCA -> TATTCTACCAC
AACACCGTAGT -> ACACCGTAGTG
GCTGTGTGGGC -> CTGTGTGGGCA
CTATGCACGCC -> TATGCACGCCT
ACCTCCAGGAC -> CCTCCAGGACT
GCCGCTCTGTG -> CCGCTCTGTGA
ATACGGAACCA -> TACGGAACCAA
GAAGTAATTTT -> AAGTAATTTTT
ATGTTAGACTG -> TGTTAGACTGG
CTCCACGGAAG -> TCCACGGAAGG
ACTTTAACTGT -> CTTTAACTGTC
AACTGTCAGAG -> ACTGTCAGAGT
ATTTAATCAAT -> TTTAATCAATG
GAAGGATTCGA -> AAGGATTCGAC
ACACCATGATA -> CACCATGATAA
TGGATATCTTG -> GGATATCTTGT
ACGAAAAAATT -> CGAAAAAATTA
ATCAGTCCATC -> TCAGTCCATCG
GAACACCTGTA -> AACACCTGTAA
CGTATATTTCT -> GTATATTTCTA
ATTCGACAAAT -> TTCGACAAATT
GGGAAATTCCC -> GGAAATTCCCT
GTCTGGCGACG -> TCTGGCGACGA
GAAAAGTAGAA -> AAAAGTAGAAG
AAATATTCGTA -> AATATTCGTAC
CAGGACTGTCA -> AGGACTGTCAG
CGCGAACAAGA -> GCGAACAAGAA
CTAATCGCGAG -> TAATCGCGAGC
AGGTGAGTCTC -> GGTGAGTCTCC
GCCCATCTGGG -> CCCATCTGGGG
GGAAGATCTAC -> GAAGATCTACG
TCCGGGCCTCG -> CCGGGCCTCGT
AAAAATTAATA -> AAAATTAATAA
CCCGCATCTTA -> CCGCATCTTAG
ATCAATGAACA -> TCAATGAACAG
ATTAAGGCAGC -> TTAAGGCAGCG
GAATGATGTTG -> AATGATGTTGA
ATCGGTACCCT -> TCGGTACCCTG
ATCCGAAACTG -> TCCGAAACTGT
GGCACGGGTCT -> GCACGGGTCTA
AAGTCTGGCGA -> AGTCTGGCGAC
AAGGGCGGAAG -> AGGGCGGAAGA
AATCCAGTCTG -> ATCCAGTCTGC
CAGCACGGATC -> AGCACGGATCC
TTAATAAGTCA -> TAATAAGTCAC
TGAAAAGTAGA -> GAAAAGTAGAA
ATGAGTATACT -> TGAGTATACTC
TTGGCTCATTT -> TGGCTCATTTA
TGCCTGGGTGA -> GCCTGGGTGAG
GACTGCGTTAG -> ACTGCGTTAGG
ACACCTGTAAC -> CACCTGTAACT
TCTAATCGCGA -> CTAATCGCGAG
TCTGGCCACTA -> CTGGCCACTAC
CTGGCATTGTC -> TGGCATTGTCT
TGCCCATTTCG -> GCCCATTTCGA
TTTCACCATGA -> TTCACCATGAC
AGCCACGGTAC -> GCCACGGTACG
GAGTCCTAAAC -> AGTCCTAAACC
TGTGGGCAAAT -> GTGGGCAAATC
TGGCCACTACC -> GGCCACTACCC
ACTTTCTCGGG -> CTTTCTCGGGT
ATGGTTACAGC -> TGGTTACAGCA
GTGGGCATAAT -> TGGGCATAATA
CCTTTTCCATC -> CTTTTCCATCC
GTGCTGAAAAC -> TGCTGAAAACT
AAACAACGCTG -> AACAACGCTGT
GCGCGTTATCT -> CGCGTTATCTG
CTTTTCCATCC -> TTTTCCATCCA
GTCACATAGTA -> TCACATAGTAA
GGACACTAAGT -> GACACTAAGTC
CGGGTAGAGGC -> GGGTAGAGGCG
GAAGGGCGGAA -> AAGGGCGGAAG
TTAGACTGGAA -> TAGACTGGAAT
AATGAACAGTA -> ATGAACAGTAA
CCGTTGTTGTA -> CGTTGTTGTAA
TTTGTCGTAAC -> TTGTCGTAACT
TTAGGCAGTCC -> TAGGCAGTCCA
ACTAGAATAAG -> CTAGAATAAGA
GAAGATCTACG -> AAGATCTACGT
CTCTGGCCACT -> TCTGGCCACTA
ATTTTTGGCTT -> TTTTTGGCTTA
GAAGAGGTTCT -> AAGAGGTTCTT
GAGCATGGGCA -> AGCATGGGCAC
ATCATGTTAGA -> TCATGTTAGAA
CTTCTGGACAT -> TTCTGGACATC
GCTGGAGAACG -> CTGGAGAACGT
TAGGGCGCCGG -> AGGGCGCCGGA
TATTTTGTCGT -> ATTTTGTCGTT
GACTAGGGAGC -> ACTAGGGAGCT
TTTCTAACTTT -> TTCTAACTTTA
GCGAAGTACGA -> CGAAGTACGAG
GGTACCCTGCG -> GTACCCTGCGT
AATTCACGACC -> ATTCACGACCG
TAGGCAGTCCA -> AGGCAGTCCAT
CTGCGTGAATG -> TGCGTGAATGA
TAGTGCCCATT -> AGTGCCCATTT
ATCGAAAACGA -> TCGAAAACGAA
TGTCGTAACTA -> GTCGTAACTAA
GCTTACACCTA -> CTTACACCTAC
AAGCGCCTTCC -> AGCGCCTTCCG
AACAAGTACTA -> ACAAGTACTAA
GTGCATGTTGT -> TGCATGTTGTG
CTGCCCTTTTC -> TGCCCTTTTCC
GAGGTTCTTGG -> AGGTTCTTGGT
CTGGACTTTTT -> TGGACTTTTTA
CCAGGATGGAG -> CAGGATGGAGG
ATCCGAAAGCG -> TCCGAAAGCGT
TCTGTGCCTCA -> CTGTGCCTCAT
TCACTTGGGGG -> CACTTGGGGGG
CCCGACACAAC -> CCGACACAACA
TCGACACTCAT -> CGACACTCATG
TTCTGCTTATA -> TCTGCTTATAC
CTCATGCTACT -> TCATGCTACTG
CGTTGTGGGCA -> GTTGTGGGCAT
CCTGCCCTTTT -> CTGCCCTTTTC
AACAAGAACGA -> ACAAGAACGAT
CAATCGGGTTG -> AATCGGGTTGG
GGACTGTCAGG -> GACTGTCAGGC
TTCACGACCGA -> TCACGACCGAT
GGACAAATATT -> GACAAATATTC
GCAAATCGGTT -> CAAATCGGTTG
AAGGCTGTGTG -> AGGCTGTGTGG
CGTCTAGGACA -> GTCTAGGACAT
GGCGGGTAGAG -> GCGGGTAGAGG
CGAGCGCGTTA -> GAGCGCGTTAT
ACAACTCCGTT -> CAACTCCGTTT
TCGGATGCGTT -> CGGATGCGTTG
CACGGACTGCG -> ACGGACTGCGT
GAGTATACTCA -> AGTATACTCAT
TCCAGTCTGCG -> CCAGTCTGCGA
AGAGTGATATT -> GAGTGATATTG
GAATGAACCGG -> AATGAACCGGA
TTCGGATGCGT -> TCGGATGCGTT
TTTGTCGTTTT -> TTGTCGTTTTT
AAATCGGTTGA -> AATCGGTTGAC
ACTCCTATGCT -> CTCCTATGCTC
GCCGTGGACTA -> CCGTGGACTAG
CCGGACTTTGC -> CGGACTTTGCG
TAAGAAGAGGT -> AAGAAGAGGTT
CGGAAGAAAGG -> GGAAGAAAGGC
AACAACTCCGT -> ACAACTCCGTT
CCTGAACACCG -> CTGAACACCGT
ATCACTTGGGG -> TCACTTGGGGG
CATGTGTTCTC -> ATGTGTTCTCG
GTAGAGGCGGC -> TAGAGGCGGCG
GAGCACATCGA -> AGCACATCGAC
CATGACCGACA -> ATGACCGACAT
CCTCATGCTAC -> CTCATGCTACT
CCATGATAAGC -> CATGATAAGCG
AGGGAGCTCCG -> GGGAGCTCCGG
GACGAGCCACG -> ACGAGCCACGG
TAAGAGGTCGT -> AAGAGGTCGTC
AGAATCACTTG -> GAATCACTTGG
TTGTGTACGAC -> TGTGTACGACG
AAAAGTAGAAG -> AAAGTAGAAGG
TCTGAATTAAC -> CTGAATTAACT
TGGTGCATGTT -> GGTGCATGTTG
GTACGAAGTAA -> TACGAAGTAAT
CACTACCCGCA -> ACTACCCGCAT
AGGACACAATA -> GGACACAATAC
AAAACAATGGT -> AAACAATGGTT
GCATAATACAG -> CATAATACAGC
ATCACAACAGC -> TCACAACAGCC
GTTAGGAAGAT -> TTAGGAAGATC
AAGTACGAGGT -> AGTACGAGGTG
ACTGATAGTGC -> CTGATAGTGCT
AATTGTTATGA -> ATTGTTATGAG
CCAAACAACGC -> CAAACAACGCT
TAATAAGTCAC -> AATAAGTCACT
TCTCCCACAGT -> CTCCCACAGTC
GAAAGAACCTC -> AAAGAACCTCC
CTGTGCCTCAT -> TGTGCCTCATG
CAATGGTTACA -> AATGGTTACAG
TTAGGGCGCCG -> TAGGGCGCCGG
CGGCCACCCGC -> GGCCACCCGCG
GAGACTAATGC -> AGACTAATGCT
AGGACATCTTA -> GGACATCTTAG
TTTGCGAGCGG -> TTGCGAGCGGC
ACCCTGCGTGA -> CCCTGCGTGAA
CCAGAATTGTT -> CAGAATTGTTA
AATTTTTGGCT -> ATTTTTGGCTT
CCTGCGTGAAT -> CTGCGTGAATG
CGTCCATCGAA -> GTCCATCGAAA
TGCCGTTGTTG -> GCCGTTGTTGT
CCGTGAAACAC -> CGTGAAACACT
ACACCGTAGTG -> CACCGTAGTGC
AATACCGCACA -> ATACCGCACAT
CTTTTTGCTAA -> TTTTTGCTAAA
CACATGCGTTG -> ACATGCGTTGG
GCTGATAGCCT -> CTGATAGCCTA
GACCGGCCGTG -> ACCGGCCGTGG
AGAATTGTTAT -> GAATTGTTATG
GTAACAAGTAC -> TAACAAGTACT
AGGCTGTGTGG -> GGCTGTGTGGG
CACCTGTAACT -> ACCTGTAACTC
CATGCGTTGGG -> ATGCGTTGGGA
CACTAGAATAA -> ACTAGAATAAG
AACTCCTATGC -> ACTCCTATGCT
TCTAACTTTAA -> CTAACTTTAAC
AGCACATCGAC -> GCACATCGACA
CTTGTGTACGA -> TTGTGTACGAC
AGCATGGGCAC -> GCATGGGCACG
CGGGTTTTGTC -> GGGTTTTGTCG
CTGGATCATGT -> TGGATCATGTT
CCTATGCACGC -> CTATGCACGCC
ATGCGTTGAAT -> TGCGTTGAATG
GCGTAGTTGTT -> CGTAGTTGTTA
AATCTGGACTT -> ATCTGGACTTT
GTCATTTAACA -> TCATTTAACAC
CGGGTGGCCTG -> GGGTGGCCTGC
TATGATGCCTG -> ATGATGCCTGG
CCTGTAACTCC -> CTGTAACTCCT
CGCCTAGGGAT -> GCCTAGGGATT
GTTTTATGACT -> TTTTATGACTT
GTTGAATGATG -> TTGAATGATGT
TGTTAGAAGCT -> GTTAGAAGCTC
TGCACGCCTAG -> GCACGCCTAGG
ACATCTTAGGC -> CATCTTAGGCA
TTGAATGATGT -> TGAATGATGTT
TGTCTAATCAG -> GTCTAATCAGT
TGGCGAAGTAC -> GGCGAAGTACG
TGTGGCGCCTA -> GTGGCGCCTAT
GTCCTTGTTTC -> TCCTTGTTTCT
GGGTACCGCCA -> GGTACCGCCAA
ATTCGTACTGA -> TTCGTACTGAT
TCGGTACCCTG -> CGGTACCCTGC
ATGTGGCGGGT -> TGTGGCGGGTA
GCTTCCTGAAT -> CTTCCTGAATG
TTGTAACTCAG -> TGTAACTCAGT
TGTGGGCATAA -> GTGGGCATAAT
TACTCATGATC -> ACTCATGATCC
CCTCGCTACGA -> CTCGCTACGAA
TGGGCACGGGT -> GGGCACGGGTC
ACGGTCGACCG -> CGGTCGACCGG
AACCGGAGCTT -> ACCGGAGCTTG
AAACGCGGGTG -> AACGCGGGTGG
TCGTTTTTCAG -> CGTTTTTCAGG
GGGGGTACCGC -> GGGGTACCGCC
CATCGACACTC -> ATCGACACTCA
CGGATCCGAAA -> GGATCCGAAAC
CTAGCACAATC -> TAGCACAATCG
ACAACAGCCTT -> CAACAGCCTTC
GAGTCTCCCAC -> AGTCTCCCACA
ATCTGGACTTT -> TCTGGACTTTT
TCTGGATCATG -> CTGGATCATGT
AACCTCCAGGA -> ACCTCCAGGAC
AAACTCGTTCG -> AACTCGTTCGG
GCACGCCTAGG -> CACGCCTAGGG
GAAGTACGAGG -> AAGTACGAGGT
CCGTCATGTGG -> CGTCATGTGGC
CTTTGAAATGG -> TTTGAAATGGG
CGATGATTACT -> GATGATTACTC
CTAAGTCTGGC -> TAAGTCTGGCG
GTGATCAGTAA -> TGATCAGTAAC
GACGGTCGACC -> ACGGTCGACCG
TCGGGTCATGA -> CGGGTCATGAC
CCATCCATATG -> CATCCATATGA
ACTTCAGCCCT -> CTTCAGCCCTT
GCACGGGTCTA -> CACGGGTCTAG
ATTGTCTTACA -> TTGTCTTACAG
AAAACTCGTTC -> AAACTCGTTCG
GCTGGAGCACA -> CTGGAGCACAT
GGGTATCCGAA -> GGTATCCGAAA
AAGTACTAAGA -> AGTACTAAGAG
ATGGTGGGACA -> TGGTGGGACAA
CGGGCCTCGTA -> GGGCCTCGTAT
TCAGTGGATGG -> CAGTGGATGGT
AGAAGGGCGGA -> GAAGGGCGGAA
GATGGAGGATG -> ATGGAGGATGG
CATATGATGCC -> ATATGATGCCT
ACAAGTACTAA -> CAAGTACTAAG
CTTAGGCAGTC -> TTAGGCAGTCC
ATACCGCACAT -> TACCGCACATG
GAAACGCGGGT -> AAACGCGGGTG
GACATGTGTTC -> ACATGTGTTCT
GTCTTACAGGA -> TCTTACAGGAA
CTGATCTTCGC -> TGATCTTCGCC
AATCGGTTGAC -> ATCGGTTGACA
TGAATGAACCG -> GAATGAACCGG
ATTTCTGATCG -> TTTCTGATCGG
TGTCTTACAGG -> GTCTTACAGGA
TCATTTAACAC -> CATTTAACACC
CTTCCGGAGCC -> TTCCGGAGCCA
GGCCGTGAAAC -> GCCGTGAAACA
TTGTTAGGGCG -> TGTTAGGGCGC
TCCGGAGCCAA -> CCGGAGCCAAC
AACGAAACGCG -> ACGAAACGCGG
GCACGGATCCG -> CACGGATCCGA
AACCCACCTCG -> ACCCACCTCGC
AAGAGGTCGTC -> AGAGGTCGTCC
ACCACTTGGCT -> CCACTTGGCTC
ACACTAAGTCT -> CACTAAGTCTG
GCGTTGGGAAA -> CGTTGGGAAAT
TAAACCGGGGG -> AAACCGGGGGT
GAGTGATATTG -> AGTGATATTGC
AATGTCACATA -> ATGTCACATAG
CATCACAACAG -> ATCACAACAGC
GATGGCGAAGT -> ATGGCGAAGTA
CTCTGGCATTG -> TCTGGCATTGT
CTGTCCTGAAC -> TGTCCTGAACA
CTACCCGCATC -> TACCCGCATCT
GCCTCGTATTT -> CCTCGTATTTT
ATGCGTAGTTG -> TGCGTAGTTGT
GGGGTACCGCC -> GGGTACCGCCA
AGTCCTTGTTT -> GTCCTTGTTTC
CTGAATTAACT -> TGAATTAACTA
GATACTGTTGT -> ATACTGTTGTC
ATTCGCGTATA -> TTCGCGTATAC
CTTGTAACAAG -> TTGTAACAAGT
TTTGCTAAACG -> TTGCTAAACGA
TGATTCCCCCA -> GATTCCCCCAG
CAACAGCCTTC -> AACAGCCTTCG
TGAGTCCTAAA -> GAGTCCTAAAC
TACGAGGTGAG -> ACGAGGTGAGT
TACTCTGTGCC -> ACTCTGTGCCT
CGCATCTTAGC -> GCATCTTAGCT
ACAAATATTCG -> CAAATATTCGT
GTGAAACACTT -> TGAAACACTTC
GTTGTTGTAAC -> TTGTTGTAACT
TTGGGGGGCTG -> TGGGGGGCTGG
CATAGTAATCC -> ATAGTAATCCA
TTGACATTGTA -> TGACATTGTAT
CGGGGGTACCG -> GGGGGTACCGC
TAATCTGGACT -> AATCTGGACTT
CATGCGTAGTT -> ATGCGTAGTTG
TATTTCTAACT -> ATTTCTAACTT
GATGAGTCCTA -> ATGAGTCCTAA
CGGAGCTTGTG -> GGAGCTTGTGC
TGATTTAATCT -> GATTTAATCTG
ACCTTTTTGCT -> CCTTTTTGCTA
CGTGACCAGAG -> GTGACCAGAGA
TAACTTTCTCG -> AACTTTCTCGG
TTACAGGAACC -> TACAGGAACCC
TGGGTCCCGGC -> GGGTCCCGGCG
TTCCTGAATGT -> TCCTGAATGTC
GTGTCCCCATC -> TGTCCCCATCA
TCCTATGCTCG -> CCTATGCTCGA
ACACCTACTCC -> CACCTACTCCG
GCGCCTATTAA -> CGCCTATTAAG
ATCATTCACCT -> TCATTCACCTT
TCGTACTGATA -> CGTACTGATAG
GATCATGTTAG -> ATCATGTTAGA
AGTACTAAGAG -> GTACTAAGAGG
CTTGGGGGGCT -> TTGGGGGGCTG
GTCCGTCATGT -> TCCGTCATGTG
TTCTCGAACTT -> TCTCGAACTTC
AACGCTGTCCT -> ACGCTGTCCTG
CCCATCACAAC -> CCATCACAACA
GGAATACAGAG -> GAATACAGAGT
GTGGGTCCCGG -> TGGGTCCCGGC
GTTCAGTTTCT -> TTCAGTTTCTC
GGTCCGTCATG -> GTCCGTCATGT
GCGTTAGATAT -> CGTTAGATATA
CAGAGAGACTA -> AGAGAGACTAA
CGGACTGCGTT -> GGACTGCGTTA
TCTTATATTCG -> CTTATATTCGG
TGTGCCTCATG -> GTGCCTCATGC
ACCGCACATGC -> CCGCACATGCG
GAGCTCCGGGT -> AGCTCCGGGTA
AATTCCCTATG -> ATTCCCTATGC
GTCGTTTTTCA -> TCGTTTTTCAG
GAACTTCAGCC -> AACTTCAGCCC
CGAGGTGAGTC -> GAGGTGAGTCT
TCCAAGAATCA -> CCAAGAATCAC
CCGGCGCATTT -> CGGCGCATTTA
TCAGTAACAAC -> CAGTAACAACT
CACCTCGCTAC -> ACCTCGCTACG
GAAACTGTGGG -> AAACTGTGGGT
GTCCGGGCCTC -> TCCGGGCCTCG
ATACAGAGTGA -> TACAGAGTGAA
GCAGTCCATCT -> CAGTCCATCTC
AACGTTGTGGG -> ACGTTGTGGGC
CTGTCAGGCTT -> TGTCAGGCTTC
CGACATGTGTT -> GACATGTGTTC
CGTTAGATATA -> GTTAGATATAA
ATAAGTCACTA -> TAAGTCACTAT
ATAGTAATCCA -> TAGTAATCCAG
CATGTTGTGTC -> ATGTTGTGTCT
ACACAGCCCAG -> CACAGCCCAGA
TAACACCATGA -> AACACCATGAT
TTTATGACTTG -> TTATGACTTGC
CCTTGTTTCTG -> CTTGTTTCTGC
CAATACCGCAC -> AATACCGCACA
ACTAGAAGGGC -> CTAGAAGGGCG
CATCGAAAACG -> ATCGAAAACGA
GTAATTTTTGG -> TAATTTTTGGC
GGGCTGGAGCA -> GGCTGGAGCAC
TTATACGTCAT -> TATACGTCATT
CTTCCTGAATG -> TTCCTGAATGT
ACAGTAAAGAG -> CAGTAAAGAGT
CGAAAACAATG -> GAAAACAATGG
AGCCCAGAATT -> GCCCAGAATTG
TTTCGAGCGCG -> TTCGAGCGCGT
TCGTCTAGGAC -> CGTCTAGGACA
CGAACAAGAAC -> GAACAAGAACG
TGAAAACTCGT -> GAAAACTCGTT
CAGTAAAGAGT -> AGTAAAGAGTG
TAACTTTAACT -> AACTTTAACTG
TGATCTTCGCC -> GATCTTCGCCT
GTTCTCGAACT -> TTCTCGAACTT
AACCCGACACA -> ACCCGACACAA
GTCATGTGGCG -> TCATGTGGCGC
GAAATGGGATG -> AAATGGGATGA
TTAGCTTGTAA -> TAGCTTGTAAC
GATGATTACTC -> ATGATTACTCT
GCGGCGAACAC -> CGGCGAACACC
ACGTTGTGGGC -> CGTTGTGGGCA
ACTGTCAGAGT -> CTGTCAGAGTG
CCTGAATGTCA -> CTGAATGTCAC
TAAAGAGTGAT -> AAAGAGTGATA
GTATACGGAAC -> TATACGGAACC
GCACAATCGGG -> CACAATCGGGT
AAGTAATTTTT -> AGTAATTTTTG
CTGGACATCTT -> TGGACATCTTA
ATGGGATGAGT -> TGGGATGAGTC
CTCTTATATTC -> TCTTATATTCG
CCCCAGGATGG -> CCCAGGATGGA
CATCTTAGCTT -> ATCTTAGCTTG
AGGCAGTCCAT -> GGCAGTCCATC
TGTTATGAGTA -> GTTATGAGTAT
TAACTAGAAGG -> AACTAGAAGGG
AAGCTCTGAAT -> AGCTCTGAATT
GAACCCGACAC -> AACCCGACACA
TTAACTAGAAG -> TAACTAGAAGG
TACGTCCGGGC -> ACGTCCGGGCC
TCGAACTTCAG -> CGAACTTCAGC
GGCATAATACA -> GCATAATACAG
GCGGGTGGCCT -> CGGGTGGCCTG
TGGGAAATTCC -> GGGAAATTCCC
CACGGTACGAA -> ACGGTACGAAG
CGTTTTTCAGG -> GTTTTTCAGGA
CGAGCATGGGC -> GAGCATGGGCA
GCCACGGTACG -> CCACGGTACGA
GAAAGGCCGTG -> AAAGGCCGTGA
CTCCCACAGTC -> TCCCACAGTCC
GACGAAAAAAT -> ACGAAAAAATT
CTGAACACCGT -> TGAACACCGTA
AGCTCCGGGTA -> GCTCCGGGTAT
AATTTCTGATC -> ATTTCTGATCG
TACGACGGTCC -> ACGACGGTCCG
GAACCTCCAGG -> AACCTCCAGGA
TGGGATGAGTC -> GGGATGAGTCC
GCGTTATCTGG -> CGTTATCTGGA
CTGCGTTAGGA -> TGCGTTAGGAA
CCTCGTATTTT -> CTCGTATTTTG
ATGACGAGCCA -> TGACGAGCCAC
AAAGTAGAAGG -> AAGTAGAAGGA
ATTGCCGTTGT -> TTGCCGTTGTT
ATCCAAGAATC -> TCCAAGAATCA
AACAGTAAAGA -> ACAGTAAAGAG
TGCCTCATGCT -> GCCTCATGCTA
GCCCAGAATTG -> CCCAGAATTGT
TACGTCATTTA -> ACGTCATTTAA
CGACGGTCCGT -> GACGGTCCGTC
AGCGTTAGATA -> GCGTTAGATAT
AGTAATTTTTG -> GTAATTTTTGG
AGTAACAACTC -> GTAACAACTCC
TCCATCTCAAA -> CCATCTCAAAA
TCCATATGATG -> CCATATGATGC
TCTAATCAGTC -> CTAATCAGTCC
AGTTGTTAGGG -> GTTGTTAGGGC
ACGTCATTTAA -> CGTCATTTAAC
ACAGAGTGAAA -> CAGAGTGAAAG
TATATTCGGAT -> ATATTCGGATG
GTTAGGGCGCC -> TTAGGGCGCCG
TGCTACTGCAC -> GCTACTGCACT
ACTTGCGTGAC -> CTTGCGTGACC
CGGAAGGACAC -> GGAAGGACACT
TTTCTCGGGTC -> TTCTCGGGTCA
GGCCTCGTATT -> GCCTCGTATTT
CACGGAAGGAC -> ACGGAAGGACA
CACTTGGCTCA -> ACTTGGCTCAT
TCGAAAACGAA -> CGAAAACGAAG
TCTGGGGATCC -> CTGGGGATCCA
TTCAGTTTCTC -> TCAGTTTCTCT
GCGGAAGAAAG -> CGGAAGAAAGG
AAGGCCGTGAA -> AGGCCGTGAAA
ACCCACCTCGC -> CCCACCTCGCT
TTTCTCTGGCA -> TTCTCTGGCAT
ATTCCCCCAGG -> TTCCCCCAGGA
GTTTTGTCGTA -> TTTTGTCGTAA
TCAGCCCTTCA -> CAGCCCTTCAG
CTACTCCGACG -> TACTCCGACGG
TCATGCTACTG -> CATGCTACTGC
GTATATTTCTA -> TATATTTCTAA
TTAGGAAGATC -> TAGGAAGATCT
GCGCATTTAAC -> CGCATTTAACT
GATAGTGCTGA -> ATAGTGCTGAA
CAGTCTGCGAC -> AGTCTGCGACA
TCCGAAAGCGT -> CCGAAAGCGTA
CTCGAACTTCA -> TCGAACTTCAG
GTGGCGGGTAG -> TGGCGGGTAGA
CTGGGTGAGTC -> TGGGTGAGTCC
TCCAGGACTGT -> CCAGGACTGTC
ACGCTCTGGCC -> CGCTCTGGCCA
ATATGATGCCT -> TATGATGCCTG
CGAAAACGAAG -> GAAAACGAAGT
ATATTGCCGTT -> TATTGCCGTTG
GGCGAAGTACG -> GCGAAGTACGA
TCCATTCGCGT -> CCATTCGCGTA
GCGCCGGACTT -> CGCCGGACTTT
TACAGCTGGAG -> ACAGCTGGAGA
TTCTAACTTTA -> TCTAACTTTAA
GCTGAAAACTC -> CTGAAAACTCG
TACACTGATCT -> ACACTGATCTT
GATGCGTTGAA -> ATGCGTTGAAT
CGACACTCATG -> GACACTCATGC
GACACTCATGC -> ACACTCATGCG
TGATTACTCTG -> GATTACTCTGT
ATACGAATTTT -> TACGAATTTTT
TTGTAACAAGT -> TGTAACAAGTA
TATTAAGGCAG -> ATTAAGGCAGC
ACCGGAGCTTG -> CCGGAGCTTGT
TTTAACTGTCA -> TTAACTGTCAG
AAACAATGGTT -> AACAATGGTTA
GAAAAAATTAA -> AAAAAATTAAT
CCGGGGGTACC -> CGGGGGTACCG
TCACGGACTGC -> CACGGACTGCG
ACGCGGGTGGC -> CGCGGGTGGCC
TTAACTTTCTC -> TAACTTTCTCG
AACACCTGTAA -> ACACCTGTAAC
ACACAATACCG -> CACAATACCGC
TGAAATGGGAT -> GAAATGGGATG
TTGTCGTAACT -> TGTCGTAACTA
CACCTTTTTGC -> ACCTTTTTGCT
CTAAGAGGTCG -> TAAGAGGTCGT
CAACGAAACGC -> AACGAAACGCG
AGGCTTCCTGA -> GGCTTCCTGAA
AGTGCTGAAAA -> GTGCTGAAAAC
TCCTGAATGTC -> CCTGAATGTCA
AATCAATGAAC -> ATCAATGAACA
TTGGCTTACAC -> TGGCTTACACC
AGAAGAGGTTC -> GAAGAGGTTCT
GAATTGTTATG -> AATTGTTATGA
TCAGAGTGTTC -> CAGAGTGTTCA
AACCGGGGGTA -> ACCGGGGGTAC
TTGTGCCCATC -> TGTGCCCATCT
GAATTAACTAG -> AATTAACTAGA
TGTTGAAAAGT -> GTTGAAAAGTA
TTGTGTCTAAT -> TGTGTCTAATC
CCAACAAGGCT -> CAACAAGGCTG
GGCGCCTATTA -> GCGCCTATTAA
GTCTAATCGCG -> TCTAATCGCGA
CCGGAGCCAAC -> CGGAGCCAACA
CGAAGACTACT -> GAAGACTACTT
AAGAGTGATAT -> AGAGTGATATT
CTTCGCCTCTC -> TTCGCCTCTCT
GCGAGCATGGG -> CGAGCATGGGC
CGTCCGGGCCT -> GTCCGGGCCTC
ACGGGTCTAGC -> CGGGTCTAGCA
AACACTTCTGG -> ACACTTCTGGA
ACCAGAGAGAC -> CCAGAGAGACT
GCGTGAATGAA -> CGTGAATGAAC
ATAAGAAGAGG -> TAAGAAGAGGT
TTTGAATGATT -> TTGAATGATTC
TCAGTCCATCG -> CAGTCCATCGG
AATACAGCTGG -> ATACAGCTGGA
CAGGAACCCGA -> AGGAACCCGAC
AGACTACTTTG -> GACTACTTTGA
TCCCATGTTAG -> CCCATGTTAGA
ACGACCGATGA -> CGACCGATGAT
GTCTCCCACAG -> TCTCCCACAGT
ATTTCTAACTT -> TTTCTAACTTT
TTTAATCTGGA -> TTAATCTGGAC
TTAGAAGCTCT -> TAGAAGCTCTG
GGGTAGAGGCG -> GGTAGAGGCGG
GGACTTTTTAT -> GACTTTTTATT
GGATGGAGGAT -> GATGGAGGATG
TCGGTTGACAT -> CGGTTGACATT
GAGATACTGTT -> AGATACTGTTG
ACGCCTAGGGA -> CGCCTAGGGAT
AGAGTGAAAGA -> GAGTGAAAGAA
AGCCCTTCAGT -> GCCCTTCAGTG
TGTTCAGTTTC -> GTTCAGTTTCT
TACAGGAACCC -> ACAGGAACCCG
ACCGGCCGTGG -> CCGGCCGTGGA
GGGGGGCTGGA -> GGGGGCTGGAG
ACGAAAACAAT -> CGAAAACAATG
TGTGTGGGCAA -> GTGTGGGCAAA
TGCGTTGGGAA -> GCGTTGGGAAA
ATTTAACTTTC -> TTTAACTTTCT
GCACTAGAATA -> CACTAGAATAA
GCCGGACTTTG -> CCGGACTTTGC
ACCGGGGGTAC -> CCGGGGGTACC
GGAGCTTGTGC -> GAGCTTGTGCC
CCTTCCGGAGC -> CTTCCGGAGCC
GGAAGAAAGGC -> GAAGAAAGGCC
ATGGCGAAGTA -> TGGCGAAGTAC
TGTTAGACTGG -> GTTAGACTGGA
GCTCTGGCCAC -> CTCTGGCCACT
GTCCTGAACAC -> TCCTGAACACC
TACTGCACTAG -> ACTGCACTAGA
TTAGTAGACGC -> TAGTAGACGCC
AGGGCGCCGGA -> GGGCGCCGGAC
GGATCCGAAAC -> GATCCGAAACT
CTTCGTCTAGG -> TTCGTCTAGGA
TTGAAATGGGA -> TGAAATGGGAT
TAGTAGACGCC -> AGTAGACGCCG
GAGCGGCTCCA -> AGCGGCTCCAC
ACTGTTGTCTA -> CTGTTGTCTAA
ATCTTGTGTAC -> TCTTGTGTACG
GGGATGAGTCC -> GGATGAGTCCT
CAGAGTGTTCA -> AGAGTGTTCAG
TTGTTATGAGT -> TGTTATGAGTA
GATGGTGGGAC -> ATGGTGGGACA
GTACGACGGTC -> TACGACGGTCC
ATTTAATCTGG -> TTTAATCTGGA
ATTTCGAGCGC -> TTTCGAGCGCG
TCCCCCAGGAT -> CCCCCAGGATG
CTCATGATCCA -> TCATGATCCAT
GGAAATTCCCT -> GAAATTCCCTA
TCACGACCGAT -> CACGACCGATG
TCATGCGTAGT -> CATGCGTAGTT
TTTGGCTTACA -> TTGGCTTACAC
GGTGAGTCTCC -> GTGAGTCTCCC
CGTAACTAACC -> GTAACTAACCC
TGTAACTCAGT -> GTAACTCAGTG
GTATACTCATG -> TATACTCATGA
TCCGTCATGTG -> CCGTCATGTGG
CACTGATCTTC -> ACTGATCTTCG
CGAAACTGTGG -> GAAACTGTGGG
ACTGATCTTCG -> CTGATCTTCGC
GAAGACTACTT -> AAGACTACTTT
TCATGATCCAT -> CATGATCCATT
CCGCATCTTAG -> CGCATCTTAGC
TTCAGTGTCCC -> TCAGTGTCCCC
ATCTTAGCTTG -> TCTTAGCTTGT
CTTACAGGAAC -> TTACAGGAACC
CGAAGTCACGG -> GAAGTCACGGA
GACACAACACA -> ACACAACACAG
CTAGAATAAGA -> TAGAATAAGAA
TGGCGGGTAGA -> GGCGGGTAGAG
GTGGACTAGGG -> TGGACTAGGGA
AGAACGTTAAT -> GAACGTTAATT
ATGAACAGTAA -> TGAACAGTAAA
GTAGAAGGATT -> TAGAAGGATTC
TCTGTGATCAG -> CTGTGATCAGT
CAGGCTTCCTG -> AGGCTTCCTGA
ATGCCTGGGTG -> TGCCTGGGTGA
AGTCACGGACT -> GTCACGGACTG
TATCATTCACC -> ATCATTCACCT
CGACGGTCGAC -> GACGGTCGACC
CATCTCAAAAC -> ATCTCAAAACG
TGTTGTCTAAT -> GTTGTCTAATC
ATGGACTCCCA -> TGGACTCCCAT
TAAGCGCCTTC -> AAGCGCCTTCC
CTCGCTACGAA -> TCGCTACGAAA
GGGGATCCAAG -> GGGATCCAAGA
TTAATTCACGA -> TAATTCACGAC
TACTTTGAAAT -> ACTTTGAAATG
ACGAAGACTAC -> CGAAGACTACT
CTAACCCACCT -> TAACCCACCTC
CATTTCGAGCG -> ATTTCGAGCGC
TAAACGAAGAC -> AAACGAAGACT
CCAAGAATCAC -> CAAGAATCACT
TGAGTCTCCCA -> GAGTCTCCCAC
CAGTCCATCTC -> AGTCCATCTCA
AATTAATAAGT -> ATTAATAAGTC
GCGGGTAGAGG -> CGGGTAGAGGC
AGGAAGATCTA -> GGAAGATCTAC
CTAACTTTAAC -> TAACTTTAACT
AGTGCCCATTT -> GTGCCCATTTC
ATCTCAAAACG -> TCTCAAAACGT
TTGTTTCTGCT -> TGTTTCTGCTT
GGGTCTAGCAC -> GGTCTAGCACA
CAATACGAATT -> AATACGAATTT
TAGCTTGTAAC -> AGCTTGTAACA
TTTTATGACTT -> TTTATGACTTG
TAATTTTTGGC -> AATTTTTGGCT
GACTCCCATGT -> ACTCCCATGTT
TCTACGTCCGG -> CTACGTCCGGG
TCAGGCTTCCT -> CAGGCTTCCTG
ACCGATGATTA -> CCGATGATTAC
AGCTCTGAATT -> GCTCTGAATTA
TGGGTGAGTCC -> GGGTGAGTCCT
TCTTAGGCAGT -> CTTAGGCAGTC
GCGAACACCTG -> CGAACACCTGT
GTTTCTGCTTA -> TTTCTGCTTAT
TCCATCGAAAA -> CCATCGAAAAC
CCGTAGTGCCC -> CGTAGTGCCCA
GAGCCACGGTA -> AGCCACGGTAC
GATTACTCTGT -> ATTACTCTGTG
ATTGTTATGAG -> TTGTTATGAGT
GCCGTGAAACA -> CCGTGAAACAC
TGTGATCAGTA -> GTGATCAGTAA
TTGTCGTTTTT -> TGTCGTTTTTC
CATTGTATCAT -> ATTGTATCATT
TTTTTCACCAT -> TTTTCACCATG
CGTTAATTCAC -> GTTAATTCACG
TGGTGATTTAA -> GGTGATTTAAT
TGAACACCGTA -> GAACACCGTAG
CATGACGAGCC -> ATGACGAGCCA
CTTCAGCCCTT -> TTCAGCCCTTC
AACCAATACGA -> ACCAATACGAA
GGAACCCGACA -> GAACCCGACAC
TAAGGCAGCGT -> AAGGCAGCGTT
TACCACTTGGC -> ACCACTTGGCT
ATGATTACTCT -> TGATTACTCTG
GCTCTGTGATC -> CTCTGTGATCA
TGGAATACAGA -> GGAATACAGAG
TAACTCCTATG -> AACTCCTATGC
CCCTATGCACG -> CCTATGCACGC
TCTACCACTTG -> CTACCACTTGG
CATTCACCTTT -> ATTCACCTTTT
AATGAACCGGA -> ATGAACCGGAG
GGGTCATGACG -> GGTCATGACGA
GGTGGGACAAA -> GTGGGACAAAT
CCGCTCTGTGA -> CGCTCTGTGAT
GACAAATATTC -> ACAAATATTCG
CACAATCGGGT -> ACAATCGGGTT
TCCCGGCGCAT -> CCCGGCGCATT
TACGAAGTAAT -> ACGAAGTAATT
TCTCGAACTTC -> CTCGAACTTCA
AGCGCGTTATC -> GCGCGTTATCT
GATCGGTACCC -> ATCGGTACCCT
ACAGCACGGAT -> CAGCACGGATC
AACAAGGCTGT -> ACAAGGCTGTG
CCACGGTACGA -> CACGGTACGAA
CCTACTCCGAC -> CTACTCCGACG
TCATGACGAGC -> CATGACGAGCC
ACTAACCCACC -> CTAACCCACCT
CGTTATCTGGA -> GTTATCTGGAT
GTCACGGACTG -> TCACGGACTGC
GAACAGTAAAG -> AACAGTAAAGA
GTAGTGCCCAT -> TAGTGCCCATT
TTTAACTTTCT -> TTAACTTTCTC
TTCTGATCGGT -> TCTGATCGGTA
CTGAATGTCAC -> TGAATGTCACA
CATTTAACTTT -> ATTTAACTTTC
ACCAATACGAA -> CCAATACGAAT
GGCCTGCCCTT -> GCCTGCCCTTT
CGTATTTTGTC -> GTATTTTGTCG
GCCTTCCGGAG -> CCTTCCGGAGC
CGCCGCTCTGT -> GCCGCTCTGTG
GTCCCGGCGCA -> TCCCGGCGCAT
CCTATGGATAT -> CTATGGATATC
GGTCATGACGA -> GTCATGACGAG
CGAATTTTTCA -> GAATTTTTCAC
CGCCAAACAAC -> GCCAAACAACG
CCTCTCTTATA -> CTCTCTTATAT
GTAAAGAGTGA -> TAAAGAGTGAT
TACTGATAGTG -> ACTGATAGTGC
TTCCCTATGCA -> TCCCTATGCAC
GGGTGGCCTGC -> GGTGGCCTGCC
TGAATGATTCC -> GAATGATTCCC
CGGTCGACCGG -> GGTCGACCGGC
AATGATGTTGA -> ATGATGTTGAA
GACCAGAGAGA -> ACCAGAGAGAC
TCGCGTATACG -> CGCGTATACGG
GTTTCTCTGGC -> TTTCTCTGGCA
CTTATATTCGG -> TTATATTCGGA
ATTGTATCATT -> TTGTATCATTC
TAGTTGTTAGG -> AGTTGTTAGGG
GACGCCGCTCT -> ACGCCGCTCTG
CAAGGCTGTGT -> AAGGCTGTGTG
ATATAATCAAC -> TATAATCAACG
GCGGCTCCACG -> CGGCTCCACGG
TCTTAGCTTGT -> CTTAGCTTGTA
GTGAGTCTCCC -> TGAGTCTCCCA
AAGAACGATGG -> AGAACGATGGC
AGGCCGTGAAA -> GGCCGTGAAAC
TTGAAAAGTAG -> TGAAAAGTAGA
GAAAACTCGTT -> AAAACTCGTTC
CTTGCGTGACC -> TTGCGTGACCA
GAAGTCACGGA -> AAGTCACGGAC
ATGTTGAAAAG -> TGTTGAAAAGT
AGTAAAGAGTG -> GTAAAGAGTGA
TAGCCTATGGA -> AGCCTATGGAT
GATGCCTGGGT -> ATGCCTGGGTG
CTTATACGTCA -> TTATACGTCAT
TCCGACGGTCG -> CCGACGGTCGA
AAGTCACTATG -> AGTCACTATGT
CACGCCTAGGG -> ACGCCTAGGGA
AAGTAGAAGGA -> AGTAGAAGGAT
GTCCCCATCAC -> TCCCCATCACA
CCATATGATGC -> CATATGATGCC
GAGAACGTTAA -> AGAACGTTAAT
TTACAGCACGG -> TACAGCACGGA
AAGGACACTAA -> AGGACACTAAG
TTCGCGTATAC -> TCGCGTATACG
ACAGGAACCCG -> CAGGAACCCGA
ACCCGCGAACA -> CCCGCGAACAA
TGATGTTGAAA -> GATGTTGAAAA
AATAAGAAGAG -> ATAAGAAGAGG
AAACACTTCTG -> AACACTTCTGG
CTCGAGATACT -> TCGAGATACTG
ATGACCGACAT -> TGACCGACATG
TTAACTGTCAG -> TAACTGTCAGA
GGACATCTTAG -> GACATCTTAGT,GACATCTTAGG
ATTTAACACCA -> TTTAACACCAT
ATTCACCTTTT -> TTCACCTTTTT
GCTTGTAACAA -> CTTGTAACAAG
GTACTAAGAGG -> TACTAAGAGGT
CTGTGTGGGCA -> TGTGTGGGCAA
CCTAGGGATTT -> CTAGGGATTTG
TCTTGGTGATT -> CTTGGTGATTT
CCATCGAAAAC -> CATCGAAAACG
ATCCATATGAT -> TCCATATGATG
CGTCATTTAAC -> GTCATTTAACA
GCTTATACGTC -> CTTATACGTCA
ATGTTGTGTCT -> TGTTGTGTCTA
CAGTAACAACT -> AGTAACAACTC
TCCTAAACCGG -> CCTAAACCGGG
TCTCAAAACGT -> CTCAAAACGTT
ACATTGTATCA -> CATTGTATCAT
GGGCGCCGGAC -> GGCGCCGGACT
GTACGAGGTGA -> TACGAGGTGAG
GAAACACTTCT -> AAACACTTCTG
AGGCGGCGAAC -> GGCGGCGAACA
TGGGCAAATCG -> GGGCAAATCGG
TTCCATCCATA -> TCCATCCATAT
GTGTTCTCGAA -> TGTTCTCGAAC
GGGATTTGAAT -> GGATTTGAATG
AGAACCTCCAG -> GAACCTCCAGG
TTGGGAAATTC -> TGGGAAATTCC
AGTATACTCAT -> GTATACTCATG
TAGAATAAGAA -> AGAATAAGAAG
GCACATCGACA -> CACATCGACAC
GCCACCCGCGA -> CCACCCGCGAA
GCTCCGGGTAT -> CTCCGGGTATC
CGACGAAAAAA -> GACGAAAAAAT
TGGCTCATTTA -> GGCTCATTTAA
AGCGTATATTT -> GCGTATATTTC
CCTCCAGGACT -> CTCCAGGACTG
GGCTCCACGGA -> GCTCCACGGAA
GCCTCTCTTAT -> CCTCTCTTATA
CTACACTGATC -> TACACTGATCT
CATTTAATCAA -> ATTTAATCAAT
CTGGAGAACGT -> TGGAGAACGTT
AGATACTGTTG -> GATACTGTTGT
TATCCGAAAGC -> ATCCGAAAGCG
ATGGAGGATGG -> TGGAGGATGGA
TGTCAGAGTGT -> GTCAGAGTGTT
TTCGTACTGAT -> TCGTACTGATA
GAGAGACTAAT -> AGAGACTAATG
TGCGTGAATGA -> GCGTGAATGAA
CCCTTTTCCAT -> CCTTTTCCATC
GAAAACGAAGT -> AAAACGAAGTC
CGACAGCCGGC -> GACAGCCGGCG
CTCATTTAATC -> TCATTTAATCA
CGCTGTCCTGA -> GCTGTCCTGAA
ATAATCAACGA -> TAATCAACGAA
GAAATTCCCTA -> AAATTCCCTAT
TACAGAGTGAA -> ACAGAGTGAAA
ACAGCCGGCGC -> CAGCCGGCGCT
CAAACAACGCT -> AAACAACGCTG
GTACTGATAGT -> TACTGATAGTG
CTCCGTTTTAT -> TCCGTTTTATG
TCTTACAGGAA -> CTTACAGGAAC
CGCACATGCGT -> GCACATGCGTT
CAGCCGGCGCT -> AGCCGGCGCTG
CCGCACATGCG -> CGCACATGCGT
AATGGGATGAG -> ATGGGATGAGT
ATACAGCTGGA -> TACAGCTGGAG
TTATGACTTGC -> TATGACTTGCG
ACGATGGCGAA -> CGATGGCGAAG
TTTTGTCGTAA -> TTTGTCGTAAC
TTTTATTCTAC -> TTTATTCTACC
TGTACGACGGT -> GTACGACGGTC
CTGTGGGTCCC -> TGTGGGTCCCG
TGGTTACAGCA -> GGTTACAGCAC
TTGAATGATTC -> TGAATGATTCC
GGACTCCCATG -> GACTCCCATGT
ATCTGGATCAT -> TCTGGATCATG
ACTCATGCGTA -> CTCATGCGTAG
CACAACAGCCT -> ACAACAGCCTT
TTTTTCAGGAC -> TTTTCAGGACA
CTCCGGGTATC -> TCCGGGTATCC
ACACTCATGCG -> CACTCATGCGT
CTATGCTCGAG -> TATGCTCGAGA
CCTTCGTCTAG -> CTTCGTCTAGG
ATCTTAGGCAG -> TCTTAGGCAGT
CTTTTTATTCT -> TTTTTATTCTA
CGTTGTTGTAA -> GTTGTTGTAAC
GGCGCATTTAA -> GCGCATTTAAC
AGCACGGATCC -> GCACGGATCCG
TGTTTCTGCTT -> GTTTCTGCTTA
TGAAACACTTC -> GAAACACTTCT
AGGAACCCGAC -> GGAACCCGACA
CGACACAACAC -> GACACAACACA
TGTGGCGGGTA -> GTGGCGGGTAG
TCGTAACTAAC -> CGTAACTAACC
GAACACCGTAG -> AACACCGTAGT
CCGAAAGCGTA -> CGAAAGCGTAT
GCCTGGGTGAG -> CCTGGGTGAGT
CGGTACCCTGC -> GGTACCCTGCG
CATTCGCGTAT -> ATTCGCGTATA
GTGGGACAAAT -> TGGGACAAATA
TTATATTCGGA -> TATATTCGGAT
CAGCCCAGAAT -> AGCCCAGAATT
TTTATTCTACC -> TTATTCTACCA
ACGGAACCAAT -> CGGAACCAATA
TTGCCGTTGTT -> TGCCGTTGTTG
GATTTAATCTG -> ATTTAATCTGG
GGATTTGAATG -> GATTTGAATGA
TAACTAACCCA -> AACTAACCCAC
CCCTGCGTGAA -> CCTGCGTGAAT
ACAACGCTGTC -> CAACGCTGTCC
GGTGCATGTTG -> GTGCATGTTGT
CCATCACAACA -> CATCACAACAG
AGAGAGACTAA -> GAGAGACTAAT
AGGATTCGACA -> GGATTCGACAA
TTCGCCTCTCT -> TCGCCTCTCTT
ACAATGGTTAC -> CAATGGTTACA
ATCGACACTCA -> TCGACACTCAT
AAGAATCACTT -> AGAATCACTTG
TCCATCGGGTT -> CCATCGGGTTT
GTAACTCCTAT -> TAACTCCTATG
ATGATTCCCCC -> TGATTCCCCCA
TCCATCCATAT -> CCATCCATATG
ATTAATAAGTC -> TTAATAAGTCA
GTTAGAAGCTC -> TTAGAAGCTCT
CCACCCGCGAA -> CACCCGCGAAC
TGTGTCTAATC -> GTGTCTAATCA
CCCAGAATTGT -> CCAGAATTGTT
CGTTGGGAAAT -> GTTGGGAAATT
TGGGCATAATA -> GGGCATAATAC
GGGCAAATCGG -> GGCAAATCGGT
CTCAGTGGATG -> TCAGTGGATGG
ACTGGAATACA -> CTGGAATACAG
TCTGGCATTGT -> CTGGCATTGTC
TATTCGGATGC -> ATTCGGATGCG
CCCATCTGGGG -> CCATCTGGGGA
TTGGTGCATGT -> TGGTGCATGTT
ACGCCGCTCTG -> CGCCGCTCTGT
TGCACTAGAAT -> GCACTAGAATA
GTTATCTGGAT -> TTATCTGGATC
TGACCAGAGAG -> GACCAGAGAGA
TGAGTCCTTGT -> GAGTCCTTGTT
TGAATGTCACA -> GAATGTCACAT
GGACTTTGCGA -> GACTTTGCGAG
GTGTGGGCAAA -> TGTGGGCAAAT
TTTCAGGACAC -> TTCAGGACACA
ACTCTGTGCCT -> CTCTGTGCCTC
AGACTGGAATA -> GACTGGAATAC
GAATACAGAGT -> AATACAGAGTG
AGCTTGTAACA -> GCTTGTAACAA
ACTAGGGAGCT -> CTAGGGAGCTC
ACGTCCGGGCC -> CGTCCGGGCCT
GACCGATGATT -> ACCGATGATTA
GAAGAAAGGCC -> AAGAAAGGCCG
GTTTTTCAGGA -> TTTTTCAGGAC
GCTACACTGAT -> CTACACTGATC
CATCGGGTTTT -> ATCGGGTTTTG
ATGTGGCGCCT -> TGTGGCGCCTA
GGCTTCCTGAA -> GCTTCCTGAAT
GGCCACTACCC -> GCCACTACCCG
GTCATGACGAG -> TCATGACGAGC
CAGAATTGTTA -> AGAATTGTTAT
TTATCTGGATC -> TATCTGGATCA
GCGTATATTTC -> CGTATATTTCT
GTTGGTGCATG -> TTGGTGCATGT
AGTCTGGCGAC -> GTCTGGCGACG
GCCCTTCAGTG -> CCCTTCAGTGT
GTTAATTCACG -> TTAATTCACGA
TCTCTGGCATT -> CTCTGGCATTG
ACAGCTGGAGA -> CAGCTGGAGAA
TGAACAGTAAA -> GAACAGTAAAG
TAGACGCCGCT -> AGACGCCGCTC
CCCACCTCGCT -> CCACCTCGCTA
TTGTATCATTC -> TGTATCATTCA
GGGTTTTGTCG -> GGTTTTGTCGT
ACTCCCATGTT -> CTCCCATGTTA
TTCTCGGGTCA -> TCTCGGGTCAT
GACTAATGCTA -> ACTAATGCTAC
TCGACCGGCCG -> CGACCGGCCGT
CGTGGACTAGG -> GTGGACTAGGG
ATAGCCTATGG -> TAGCCTATGGA
ATCTACGTCCG -> TCTACGTCCGG
GTCGTCCATCG -> TCGTCCATCGA
AAAACGAAGTC -> AAACGAAGTCA
GTTCGGCCACC -> TTCGGCCACCC
CATTGTCTTAC -> ATTGTCTTACA
TTAAGGCAGCG -> TAAGGCAGCGT
TGTTAGGGCGC -> GTTAGGGCGCC
TGTCGTTTTTC -> GTCGTTTTTCA
TTAACACCATG -> TAACACCATGA
TTTCTGCTTAT -> TTCTGCTTATA
GATTTGAATGA -> ATTTGAATGAT
CCAATACGAAT -> CAATACGAATT
GTATCATTCAC -> TATCATTCACC
AGAGTGTTCAG -> GAGTGTTCAGT
TTGTGGGCATA -> TGTGGGCATAA
GGGCGGAAGAA -> GGCGGAAGAAA
CTGTAACTCCT -> TGTAACTCCTA
ACTCAGTGGAT -> CTCAGTGGATG
CTGCACTAGAA -> TGCACTAGAAT
GACTTGCGTGA -> ACTTGCGTGAC
CGGCGCTGATA -> GGCGCTGATAG
GTTGTAACTCA -> TTGTAACTCAG
AACAATGGTTA -> ACAATGGTTAC
GTCCATCGAAA -> TCCATCGAAAA
CTGGCCACTAC -> TGGCCACTACC
CTCCAGGACTG -> TCCAGGACTGT
GACCGACATGT -> ACCGACATGTG
GATCCGAAACT -> ATCCGAAACTG
GGACTGCGTTA -> GACTGCGTTAG
TAATCCAGTCT -> AATCCAGTCTG
TTTAATCAATG -> TTAATCAATGA
TACTAAGAGGT -> ACTAAGAGGTC
ATACGTCATTT -> TACGTCATTTA
AATTTTTCACC -> ATTTTTCACCA
CAGTGGATGGT -> AGTGGATGGTG
GAGGTCGTCCA -> AGGTCGTCCAT
GCGTATACGGA -> CGTATACGGAA
ATGCTACACTG -> TGCTACACTGA
TACAGCACGGA -> ACAGCACGGAT
TAGCACAATCG -> AGCACAATCGG
TCACAACAGCC -> CACAACAGCCT
GACATCTTAGT -> ACATCTTAGTA
AACGCGGGTGG -> ACGCGGGTGGC
GGATATCTTGT -> GATATCTTGTG
TCACATAGTAA -> CACATAGTAAT
CTGATAGTGCT -> TGATAGTGCTG
GACATCTTAGG -> ACATCTTAGGC
CGTCATGTGGC -> GTCATGTGGCG
TCGCGAGCATG -> CGCGAGCATGG
CCGATGATTAC -> CGATGATTACT
GAACGTTAATT -> AACGTTAATTC
AAAGAGTGATA -> AAGAGTGATAT
TCGGCCACCCG -> CGGCCACCCGC
GTAGACGCCGC -> TAGACGCCGCT
CTGGCGACGAA -> TGGCGACGAAA
TACGAATTTTT -> ACGAATTTTTC
ACGCTGTCCTG -> CGCTGTCCTGA
TATACGGAACC -> ATACGGAACCA
CGTAGTGCCCA -> GTAGTGCCCAT
AATGCTACACT -> ATGCTACACTG
GGTTACAGCAC -> GTTACAGCACG
AGACTAATGCT -> GACTAATGCTA
TGCTCGAGATA -> GCTCGAGATAC
GATATAATCAA -> ATATAATCAAC
TCCTGAACACC -> CCTGAACACCG
TGTAACAAGTA -> GTAACAAGTAC
TATGACTTGCG -> ATGACTTGCGT
GCTGTCCTGAA -> CTGTCCTGAAC
CCTATTAAGGC -> CTATTAAGGCA
GCATGGGCACG -> CATGGGCACGG
TGCGTAGTTGT -> GCGTAGTTGTT
GGGGCTGGAGC -> GGGCTGGAGCA
CGTTGAATGAT -> GTTGAATGATG
GAATAAGAAGA -> AATAAGAAGAG
TACACCTACTC -> ACACCTACTCC
TGACATTGTAT -> GACATTGTATC
AATCGCGAGCA -> ATCGCGAGCAT
GCCACTACCCG -> CCACTACCCGC
CGAGATACTGT -> GAGATACTGTT
TGGCATTGTCT -> GGCATTGTCTT
CCATCTGGGGA -> CATCTGGGGAT
ATTCGGATGCG -> TTCGGATGCGT
CGGCTCCACGG -> GGCTCCACGGA
ATTTTTCACCA -> TTTTTCACCAT
GTGACCAGAGA -> TGACCAGAGAG
AAATTCCCTAT -> AATTCCCTATG
GAAAACAATGG -> AAAACAATGGT
CTAAACCGGGG -> TAAACCGGGGG
ACTACTTTGAA -> CTACTTTGAAA
TCCGGGTATCC -> CCGGGTATCCG
ATGCGTTGGGA -> TGCGTTGGGAA
TCCCCATCACA -> CCCCATCACAA
TAGTAATCCAG -> AGTAATCCAGT
CCCCATCACAA -> CCCATCACAAC
TGATCCATTCG -> GATCCATTCGC
CTCTGTGATCA -> TCTGTGATCAG
TCGCCTCTCTT -> CGCCTCTCTTA
GGATGCGTTGA -> GATGCGTTGAA
GAGGATGGACT -> AGGATGGACTC
TGGGGATCCAA -> GGGGATCCAAG
ACACTTCTGGA -> CACTTCTGGAC
ATCTTAGTAGA -> TCTTAGTAGAC
GCAGCGTTAGA -> CAGCGTTAGAT
TGCCCATCTGG -> GCCCATCTGGG
CTGTGATCAGT -> TGTGATCAGTA
GAACAAGAACG -> AACAAGAACGA
GGTACCGCCAA -> GTACCGCCAAA
AACACAGCCCA -> ACACAGCCCAG
TTTTGCTAAAC -> TTTGCTAAACG
ACTCATGATCC -> CTCATGATCCA
TAATGCTACAC -> AATGCTACACT
GAACCAATACG -> AACCAATACGA
GTGGGCAAATC -> TGGGCAAATCG
CCATCGGGTTT -> CATCGGGTTTT
ATCAGTAACAA -> TCAGTAACAAC
ACACTGATCTT -> CACTGATCTTC
GTGTTCAGTTT -> TGTTCAGTTTC
GCATTTAACTT -> CATTTAACTTT
TTGTCTAATCG -> TGTCTAATCGC
GGTTGGTGCAT -> GTTGGTGCATG
CGAAACGCGGG -> GAAACGCGGGT
TAGTGCTGAAA -> AGTGCTGAAAA
TTACTCTGTGC -> TACTCTGTGCC
AGCACAATCGG -> GCACAATCGGG
CTACGAAAACA -> TACGAAAACAA
ACTTCTGGACA -> CTTCTGGACAT
TCACCTTTTTG -> CACCTTTTTGC
CCACGGAAGGA -> CACGGAAGGAC
GGCTCATTTAA -> GCTCATTTAAT
TCTGGACTTTT -> CTGGACTTTTT
GTGGATGGTGG -> TGGATGGTGGG
TGTGCCCATCT -> GTGCCCATCTG
AAACTGTGGGT -> AACTGTGGGTC
TCATTCACCTT -> CATTCACCTTT
CAGGATGGAGG -> AGGATGGAGGA
TACCCTGCGTG -> ACCCTGCGTGA
CTAAACGAAGA -> TAAACGAAGAC
ATGTGTTCTCG -> TGTGTTCTCGA
AGGCAGCGTTA -> GGCAGCGTTAG
CGGCCGTGGAC -> GGCCGTGGACT
CTATTAAGGCA -> TATTAAGGCAG
CCTAAACCGGG -> CTAAACCGGGG
ACTGCACTAGA -> CTGCACTAGAA
GCCTATGGATA -> CCTATGGATAT
CCATTCGCGTA -> CATTCGCGTAT
AAAATTAATAA -> AAATTAATAAG
TTCAGCCCTTC -> TCAGCCCTTCA
TATTCGTACTG -> ATTCGTACTGA
TGCTGAAAACT -> GCTGAAAACTC
GATATCTTGTG -> ATATCTTGTGT
GCTACTGCACT -> CTACTGCACTA
GCGTTAGGAAG -> CGTTAGGAAGA
TGCATGTTGTG -> GCATGTTGTGT
GAATGATTCCC -> AATGATTCCCC
TCAATGAACAG -> CAATGAACAGT
TACGGAACCAA -> ACGGAACCAAT
TGGCGCCTATT -> GGCGCCTATTA
CTCCGACGGTC -> TCCGACGGTCG
AAGAACCTCCA -> AGAACCTCCAG
TTCGACAAATT -> TCGACAAATTT
CATGATAAGCG -> ATGATAAGCGC
CACTTGGGGGG -> ACTTGGGGGGC
TGGCTTACACC -> GGCTTACACCT
CGAAGTACGAG -> GAAGTACGAGG
GTAACTCAGTG -> TAACTCAGTGG
ACCGTAGTGCC -> CCGTAGTGCCC
CTCATGCGTAG -> TCATGCGTAGT
GAGGTGAGTCT -> AGGTGAGTCTC
CTTGGCTCATT -> TTGGCTCATTT
AAGATCTACGT -> AGATCTACGTC
CGTTCGGCCAC -> GTTCGGCCACC
GGCGACGAAAA -> GCGACGAAAAA
CGGGTCTAGCA -> GGGTCTAGCAC
CGGACTTTGCG -> GGACTTTGCGA
TTGCGTGACCA -> TGCGTGACCAG
TGGTGGGACAA -> GGTGGGACAAA
CTTTCTCGGGT -> TTTCTCGGGTC
AGAGGCGGCGA -> GAGGCGGCGAA
GGAGCACATCG -> GAGCACATCGA
TTTTCACCATG -> TTTCACCATGA
GTTGAAAAGTA -> TTGAAAAGTAG
GTCACTATGTG -> TCACTATGTGG
TCCTTGTTTCT -> CCTTGTTTCTG
TACTCCGACGG -> ACTCCGACGGT
ACGGTCCGTCA -> CGGTCCGTCAT
ACTAAGTCTGG -> CTAAGTCTGGC
GTCAGAGTGTT -> TCAGAGTGTTC
CACATCGACAC -> ACATCGACACT
TTGGTGATTTA -> TGGTGATTTAA
TGGATCATGTT -> GGATCATGTTA
TGATAGCCTAT -> GATAGCCTATG
CGAGCGGCTCC -> GAGCGGCTCCA
TCCGAAACTGT -> CCGAAACTGTG
CCGGAGCTTGT -> CGGAGCTTGTG
