CTTCCGTTCCGATATGGAACAAAC -> TTCCGTTCCGATATGGAACAAACT
AGAGCAAATACCCGCTTTTCATTA -> GAGCAAATACCCGCTTTTCATTAG
GCTTACCTAGGAGTCCCACGTGGG -> CTTACCTAGGAGTCCCACGTGGGT
TATTAGGCGCTCCTAATGGCCAAC -> ATTAGGCGCTCCTAATGGCCAACT
ACGCCGTGTATATAAAGATATGTC -> CGCCGTGTATATAAAGATATGTCG
GGCTCATCCAGCTCTATGTATAGC -> GCTCATCCAGCTCTATGTATAGCA
GGGCTGACGCTCGTCTATTTTACG -> GGCTGACGCTCGTCTATTTTACGG
CGTGTCCAAAAGGTGTTCAGCGAT -> GTGTCCAAAAGGTGTTCAGCGATT
GTAATGAATCAACACTGATTCCTG -> TAATGAATCAACACTGATTCCTGG
GTTGCACAACTACACTAGGGCTGA -> TTGCACAACTACACTAGGGCTGAC
GACCAGTGCTAGTTCAGAATTCTT -> ACCAGTGCTAGTTCAGAATTCTTG
GGTTAGTGCGCATTACAGGTGGAG -> GTTAGTGCGCATTACAGGTGGAGC
GGACCAGTGCTAGTTCAGAATTCT -> GACCAGTGCTAGTTCAGAATTCTT
GCTCTATGTATAGCAATTTCATGT -> CTCTATGTATAGCAATTTCATGTT
TGAGTAGGCCCAATGCGGCCGCCC -> GAGTAGGCCCAATGCGGCCGCCCT
GTGTTCAGCGATTCCATCGGACGG -> TGTTCAGCGATTCCATCGGACGGT
CGTCTCTTTTCGTCGTATGAGTAG -> GTCTCTTTTCGTCGTATGAGTAGT
CGAGTTCGGTAAGCAATTGCCATG -> GAGTTCGGTAAGCAATTGCCATGC
CGAGCGGCCAACCTATCCTTTAAA -> GAGCGGCCAACCTATCCTTTAAAG
CAGCTAACATGAACGCGACGCTAT -> AGCTAACATGAACGCGACGCTATA
TAAGTAATGAATCAACACTGATTC -> AAGTAATGAATCAACACTGATTCC
CCAACAGTGTACCAAAGGCATACT -> CAACAGTGTACCAAAGGCATACTG
GTAAAATAGCCGTCGCGGATCCAC -> TAAAATAGCCGTCGCGGATCCACA
CGGATCCCTAGATTCCATAGCGAG -> GGATCCCTAGATTCCATAGCGAGC
CCACAGGCCCTGATTGAAGACGTG -> CACAGGCCCTGATTGAAGACGTGG
AGGAGCTTTGCATCTTATACCAAC -> GGAGCTTTGCATCTTATACCAACA
TAGAGGAACTCCGGTAAAGCAATC -> AGAGGAACTCCGGTAAAGCAATCC
TCGAAGTCCAGTCCCGCGAGTTAA -> CGAAGTCCAGTCCCGCGAGTTAAT
ATCGTCTCTTTTCGTCGTATGAGT -> TCGTCTCTTTTCGTCGTATGAGTA
AGCATAGAGTATCGATTTCCACCA -> GCATAGAGTATCGATTTCCACCAG
CTCTATGTATAGCAATTTCATGTT -> TCTATGTATAGCAATTTCATGTTA
GCCGAGGTGCCTCACTTAACGGGG -> CCGAGGTGCCTCACTTAACGGGGA
CTAGTGATGGTTGTTAGAGCATTC -> TAGTGATGGTTGTTAGAGCATTCC
TACACATGCGAAGCGGGAGCCAAG -> ACACATGCGAAGCGGGAGCCAAGT
TTCAGAATTCTTGCAGTGGAACTA -> TCAGAATTCTTGCAGTGGAACTAT
AGCGGAGAATTAAGTAATGAATCA -> GCGGAGAATTAAGTAATGAATCAA
CGCACGTAAAATTTCCGAGCTTTG -> GCACGTAAAATTTCCGAGCTTTGC
CCACACAATGGACCAGTGCTAGTT -> CACACAATGGACCAGTGCTAGTTC
TTAAAGGATCAAGCCCCAGCGCCG -> TAAAGGATCAAGCCCCAGCGCCGA
CTCACAGCTAACATGAACGCGACG -> TCACAGCTAACATGAACGCGACGC
TTTCATGTTATCCACTTGCCCAAC -> TTCATGTTATCCACTTGCCCAACG
CTTTTAGTACCGAGTTCGGTAAGC -> TTTTAGTACCGAGTTCGGTAAGCA
CACCATGCTCCTTGCGAGCGGCCA -> ACCATGCTCCTTGCGAGCGGCCAA
CTTAATGCATGGCTCGCACGACAC -> TTAATGCATGGCTCGCACGACACT
ACTCACAGCTAACATGAACGCGAC -> CTCACAGCTAACATGAACGCGACG
ACGTAAAATTTCCGAGCTTTGCTG -> CGTAAAATTTCCGAGCTTTGCTGG
CGAGCCTATATTAGGCGCTCCTAA -> GAGCCTATATTAGGCGCTCCTAAT
GACAGGAATCTCGGATCCCTAGAT -> ACAGGAATCTCGGATCCCTAGATT
GCACGTCCGGTAAGTACTTGACGT -> CACGTCCGGTAAGTACTTGACGTT
GAGGGGAAGCTAGTGATGGTTGTT -> AGGGGAAGCTAGTGATGGTTGTTA
CAACTTGACAGCAAGACTGGGACG -> AACTTGACAGCAAGACTGGGACGA
TGTACACATGCGAAGCGGGAGCCA -> GTACACATGCGAAGCGGGAGCCAA
GGTGCGGCTCTGGCCTTAATGCAT -> GTGCGGCTCTGGCCTTAATGCATG
GAGTAGGCCCAATGCGGCCGCCCT -> AGTAGGCCCAATGCGGCCGCCCTT
AGCGCCGAGGTGCCTCACTTAACG -> GCGCCGAGGTGCCTCACTTAACGG
GGGCCACACAATGGACCAGTGCTA -> GGCCACACAATGGACCAGTGCTAG
ATTGCGCACGTAAAATTTCCGAGC -> TTGCGCACGTAAAATTTCCGAGCT
CTGTCGGGGGTTGTAGGGGTGCAT -> TGTCGGGGGTTGTAGGGGTGCATA
TTTAGTTTACAGTGATTATAGGCA -> TTAGTTTACAGTGATTATAGGCAG
AACGACCTAGAGGAACTCCGGTAA -> ACGACCTAGAGGAACTCCGGTAAA
TCGCGGATCCACAGGCCCTGATTG -> CGCGGATCCACAGGCCCTGATTGA
CATGCCTCGTGCAAAGCTTACAAT -> ATGCCTCGTGCAAAGCTTACAATG
CTAGTTTCCGCGGTACGACTTGTG -> TAGTTTCCGCGGTACGACTTGTGA
AATGGCTCTGAGCTTATCCGCCGA -> ATGGCTCTGAGCTTATCCGCCGAT
ACTCGTTGCACAACTACACTAGGG -> CTCGTTGCACAACTACACTAGGGC
GGGGGTTGTAGGGGTGCATAGACG -> GGGGTTGTAGGGGTGCATAGACGG
GTACTCACCGCGCCTAAAGTGGCC -> TACTCACCGCGCCTAAAGTGGCCG
TCGGATCCCTAGATTCCATAGCGA -> CGGATCCCTAGATTCCATAGCGAG
GAGCTGCTCCGATCAATAACTGAT -> AGCTGCTCCGATCAATAACTGATC
CACGCCGTGTATATAAAGATATGT -> ACGCCGTGTATATAAAGATATGTC
TCTTCCGTTCCGATATGGAACAAA -> CTTCCGTTCCGATATGGAACAAAC
GCAAAAGCCATTGGCCCTTGTGAA -> CAAAAGCCATTGGCCCTTGTGAAT
AAATCGTCTCTTTTCGTCGTATGA -> AATCGTCTCTTTTCGTCGTATGAG
TGATACAACGCCCCTCACGTGGTC -> GATACAACGCCCCTCACGTGGTCT
TTTAGTACCGAGTTCGGTAAGCAA -> TTAGTACCGAGTTCGGTAAGCAAT
ATAGGCAGGTTAGTGCGCATTACA -> TAGGCAGGTTAGTGCGCATTACAG
CTTACGGATGGTCGAAGTCCAGTC -> TTACGGATGGTCGAAGTCCAGTCC
ATGCGACTTACCAAGGCGCGTGTC -> TGCGACTTACCAAGGCGCGTGTCC
AAGACGTGGTCCGGGCTGGAAGTG -> AGACGTGGTCCGGGCTGGAAGTGT
CAAGGCGCGTGTCCAAAAGGTGTT -> AAGGCGCGTGTCCAAAAGGTGTTC
TAGGAGCTTTTAGTACCGAGTTCG -> AGGAGCTTTTAGTACCGAGTTCGG
AGACTGGGACGACTAGTAAACTCG -> GACTGGGACGACTAGTAAACTCGT
AATGAATCAACACTGATTCCTGGT -> ATGAATCAACACTGATTCCTGGTC
AAGCAATTGCCATGCCTCGTGCAA -> AGCAATTGCCATGCCTCGTGCAAA
GCTAAACTACCTTAATATAAGATC -> CTAAACTACCTTAATATAAGATCG
GAAGTCCAGTCCCGCGAGTTAATT -> AAGTCCAGTCCCGCGAGTTAATTT
ATTATAGGCAGGTTAGTGCGCATT -> TTATAGGCAGGTTAGTGCGCATTA
TGGGTCAATGGCTCTGAGCTTATC -> GGGTCAATGGCTCTGAGCTTATCC
ATGGTCGAAGTCCAGTCCCGCGAG -> TGGTCGAAGTCCAGTCCCGCGAGT
CTCTGGCCTTAATGCATGGCTCGC -> TCTGGCCTTAATGCATGGCTCGCA
GGGTAGTAATATGTTCGTAAAATA -> GGTAGTAATATGTTCGTAAAATAG
CAGTGCTAGTTCAGAATTCTTGCA -> AGTGCTAGTTCAGAATTCTTGCAG
AGGATGCGAAGGATCTCACGTGAA -> GGATGCGAAGGATCTCACGTGAAC
TGACTTTCTATAGTTATTCCGTAG -> GACTTTCTATAGTTATTCCGTAGT
AGTGGCCGTATTGGTATAAAGATC -> GTGGCCGTATTGGTATAAAGATCC
TTGACGTTTCACCACACGTCCCCG -> TGACGTTTCACCACACGTCCCCGA
GAGCAAATACCCGCTTTTCATTAG -> AGCAAATACCCGCTTTTCATTAGG
CGAAGTCCAGTCCCGCGAGTTAAT -> GAAGTCCAGTCCCGCGAGTTAATT
AATTCTTGCAGTGGAACTATTTTA -> ATTCTTGCAGTGGAACTATTTTAC
ATACCCGCTTTTCATTAGGAAACT -> TACCCGCTTTTCATTAGGAAACTC
CTAGTTCCTCCCAACTTGACAGCA -> TAGTTCCTCCCAACTTGACAGCAA
TTACCAAGGCGCGTGTCCAAAAGG -> TACCAAGGCGCGTGTCCAAAAGGT
CATTACAGGTGGAGCGTCTAAAAC -> ATTACAGGTGGAGCGTCTAAAACG
TTAATTGCGCACGTAAAATTTCCG -> TAATTGCGCACGTAAAATTTCCGA
AATTAAGTAATGAATCAACACTGA -> ATTAAGTAATGAATCAACACTGAT
CAAAACCTACGTATGGCTTGAGTT -> AAAACCTACGTATGGCTTGAGTTG
CGCTCCTAATGGCCAACTAGGGCG -> GCTCCTAATGGCCAACTAGGGCGA
AAGGCGCGTGTCCAAAAGGTGTTC -> AGGCGCGTGTCCAAAAGGTGTTCA
TCGGGGGTTGTAGGGGTGCATAGA -> CGGGGGTTGTAGGGGTGCATAGAC
GAGCTTTTAGTACCGAGTTCGGTA -> AGCTTTTAGTACCGAGTTCGGTAA
AAGGATGCGAAGGATCTCACGTGA -> AGGATGCGAAGGATCTCACGTGAA
AGTAGGCTCTTCCGTTCCGATATG -> GTAGGCTCTTCCGTTCCGATATGG
ACATAGAGGGGAAGCTAGTGATGG -> CATAGAGGGGAAGCTAGTGATGGT
GGCTTACCTAGGAGTCCCACGTGG -> GCTTACCTAGGAGTCCCACGTGGG
CCGGACATAGAGGGGAAGCTAGTG -> CGGACATAGAGGGGAAGCTAGTGA
ATAATTTCTTACGACTAGTTCCTC -> TAATTTCTTACGACTAGTTCCTCC
ACGTCCGGTAAGTACTTGACGTTT -> CGTCCGGTAAGTACTTGACGTTTC
CCGAGCTTTGCTGGCCTTCGCTAG -> CGAGCTTTGCTGGCCTTCGCTAGT
GGCTCGCACGACACTTACGAGCTG -> GCTCGCACGACACTTACGAGCTGC
TAGAGCAAATACCCGCTTTTCATT -> AGAGCAAATACCCGCTTTTCATTA
ATGGCCAACTAGGGCGAAATCGTC -> TGGCCAACTAGGGCGAAATCGTCT
TATACGAGACGCTCAGCGATGGTA -> ATACGAGACGCTCAGCGATGGTAA
CTAACATGAACGCGACGCTATACT -> TAACATGAACGCGACGCTATACTT
AGACGGCTGTGTAAAGTTTGACAG -> GACGGCTGTGTAAAGTTTGACAGG
AACTATTTTACGCATGCGAGACAT -> ACTATTTTACGCATGCGAGACATT
AATGCAGCCAAGCTCGAGAATCTC -> ATGCAGCCAAGCTCGAGAATCTCC
ATATAAACACTGGAGAACCAAGCG -> TATAAACACTGGAGAACCAAGCGG
ATAGACGGCTGTGTAAAGTTTGAC -> TAGACGGCTGTGTAAAGTTTGACA
AAACGGGGTTTAGTTTACAGTGAT -> AACGGGGTTTAGTTTACAGTGATT
TATAGTTATTCCGTAGTCTTTATG -> ATAGTTATTCCGTAGTCTTTATGC
TGCCATGCCTCGTGCAAAGCTTAC -> GCCATGCCTCGTGCAAAGCTTACA
CTTTAAAGGATCAAGCCCCAGCGC -> TTTAAAGGATCAAGCCCCAGCGCC
CTCATCCAGCTCTATGTATAGCAA -> TCATCCAGCTCTATGTATAGCAAT
TCACAGCTAACATGAACGCGACGC -> CACAGCTAACATGAACGCGACGCT
GAGCTTATCCGCCGATCGGGATCC -> AGCTTATCCGCCGATCGGGATCCA
CCAGTGCTAGTTCAGAATTCTTGC -> CAGTGCTAGTTCAGAATTCTTGCA
TGAGCGCGTAGGAGCTTTTAGTAC -> GAGCGCGTAGGAGCTTTTAGTACC
ATCAATAACTGATCTCTGTACACA -> TCAATAACTGATCTCTGTACACAT
GGATCCACAGGCCCTGATTGAAGA -> GATCCACAGGCCCTGATTGAAGAC
CACGTAAAATTTCCGAGCTTTGCT -> ACGTAAAATTTCCGAGCTTTGCTG
TCCATCGGACGGTGCGGCTCTGGC -> CCATCGGACGGTGCGGCTCTGGCC
TCCTAATGGCCAACTAGGGCGAAA -> CCTAATGGCCAACTAGGGCGAAAT
TGCACAACTACACTAGGGCTGACG -> GCACAACTACACTAGGGCTGACGC
TGAAGCTCTTGACGTTTCACCACA -> GAAGCTCTTGACGTTTCACCACAC
TGGCGAACCCTAGTAGGCTCTTCC -> GGCGAACCCTAGTAGGCTCTTCCG
CCGTTCCGATATGGAACAAACTGG -> CGTTCCGATATGGAACAAACTGGT
GCTCTGGCCTTAATGCATGGCTCG -> CTCTGGCCTTAATGCATGGCTCGC
TCGCACGACACTTACGAGCTGCTC -> CGCACGACACTTACGAGCTGCTCC
ATGCAAAAGCCATTGGCCCTTGTG -> TGCAAAAGCCATTGGCCCTTGTGA
GGGCTGGAAGTGTCGGCCGTGATT -> GGCTGGAAGTGTCGGCCGTGATTA
GAATGCAGGAGGAACGATGTTCAT -> AATGCAGGAGGAACGATGTTCATA
ACTGGTCAGTTCTACACAAAACCT -> CTGGTCAGTTCTACACAAAACCTA
ACCTAGGAGTCCCACGTGGGTCAA -> CCTAGGAGTCCCACGTGGGTCAAT
AAGTCCAGTCCCGCGAGTTAATTT -> AGTCCAGTCCCGCGAGTTAATTTT
TCTAAAACGACCTAGAGGAACTCC -> CTAAAACGACCTAGAGGAACTCCG
ACTTGTATCGCGGGATATAAACAC -> CTTGTATCGCGGGATATAAACACT
CGTCTATTTTACGGATTCTCTACA -> GTCTATTTTACGGATTCTCTACAA
GACGTGGTCCGGGCTGGAAGTGTC -> ACGTGGTCCGGGCTGGAAGTGTCG
CGTGCAAAGCTTACAATGCAGCCA -> GTGCAAAGCTTACAATGCAGCCAA
AAACGACCTAGAGGAACTCCGGTA -> AACGACCTAGAGGAACTCCGGTAA
AAGCAATCCGGCTCATCCAGCTCT -> AGCAATCCGGCTCATCCAGCTCTA
CGATGGTAAGTTAAGTCCGAGGAG -> GATGGTAAGTTAAGTCCGAGGAGC
ATCGCGGGATATAAACACTGGAGA -> TCGCGGGATATAAACACTGGAGAA
GGCCGCCCTTACGGATGGTCGAAG -> GCCGCCCTTACGGATGGTCGAAGT
TGCATCTTATACCAACAGTGTACC -> GCATCTTATACCAACAGTGTACCA
TGCAGCCAAGCTCGAGAATCTCCG -> GCAGCCAAGCTCGAGAATCTCCGG
CATAGACGGCTGTGTAAAGTTTGA -> ATAGACGGCTGTGTAAAGTTTGAC
CAATTATGAAGCTCTTGACGTTTC -> AATTATGAAGCTCTTGACGTTTCA
GAGACATTAGCTGAATTGTGTTGG -> AGACATTAGCTGAATTGTGTTGGG
GGTGTTCAGCGATTCCATCGGACG -> GTGTTCAGCGATTCCATCGGACGG
TATAAGATCGAGGCTTAGTCCACG -> ATAAGATCGAGGCTTAGTCCACGA
GGATCTCACGTGAACATTGTCTAA -> GATCTCACGTGAACATTGTCTAAT
CTTGTGAATGCAAAAGCCATTGGC -> TTGTGAATGCAAAAGCCATTGGCC
AGTGTTCGTGCAGGTGTTTAGGTA -> GTGTTCGTGCAGGTGTTTAGGTAC
ATTGAAGACGTGGTCCGGGCTGGA -> TTGAAGACGTGGTCCGGGCTGGAA
TGTTATCCACTTGCCCAACGGCTT -> GTTATCCACTTGCCCAACGGCTTA
TGTCGGCCGTGATTAGAAAAGGCG -> GTCGGCCGTGATTAGAAAAGGCGC
CATGCTCCTTGCGAGCGGCCAACC -> ATGCTCCTTGCGAGCGGCCAACCT
ACCCGCTTTTCATTAGGAAACTCA -> CCCGCTTTTCATTAGGAAACTCAC
GGAACTATTTTACGCATGCGAGAC -> GAACTATTTTACGCATGCGAGACA
GACGTTTCACCACACGTCCCCGAC -> ACGTTTCACCACACGTCCCCGACT
GATTGAAGACGTGGTCCGGGCTGG -> ATTGAAGACGTGGTCCGGGCTGGA
TTAAGGTTCTGCTGTCGGGGGTTG -> TAAGGTTCTGCTGTCGGGGGTTGT
TCAGCGATGGTAAGTTAAGTCCGA -> CAGCGATGGTAAGTTAAGTCCGAG
CTCAAGCATAGAGTATCGATTTCC -> TCAAGCATAGAGTATCGATTTCCA
TAGTTTCCGCGGTACGACTTGTGA -> AGTTTCCGCGGTACGACTTGTGAA
CATGGCTCGCACGACACTTACGAG -> ATGGCTCGCACGACACTTACGAGC
GAGTAGTGTTCGTGCAGGTGTTTA -> AGTAGTGTTCGTGCAGGTGTTTAG
CGCGGGATATAAACACTGGAGAAC -> GCGGGATATAAACACTGGAGAACC
GACCTAGAGGAACTCCGGTAAAGC -> ACCTAGAGGAACTCCGGTAAAGCA
CTATTTTACGGATTCTCTACAAAC -> TATTTTACGGATTCTCTACAAACG
TCCGATATGGAACAAACTGGTCAG -> CCGATATGGAACAAACTGGTCAGT
TGAATGCAAAAGCCATTGGCCCTT -> GAATGCAAAAGCCATTGGCCCTTG
CAATGCAGCCAAGCTCGAGAATCT -> AATGCAGCCAAGCTCGAGAATCTC
ATAGCCGTCGCGGATCCACAGGCC -> TAGCCGTCGCGGATCCACAGGCCC
GCTCATCCAGCTCTATGTATAGCA -> CTCATCCAGCTCTATGTATAGCAA
GAGGCTTAGTCCACGACCTAATAC -> AGGCTTAGTCCACGACCTAATACT
TGTGCCACCATGCTCCTTGCGAGC -> GTGCCACCATGCTCCTTGCGAGCG
TAAGCAATTGCCATGCCTCGTGCA -> AAGCAATTGCCATGCCTCGTGCAA
GGATCCCTAGATTCCATAGCGAGC -> GATCCCTAGATTCCATAGCGAGCC
ACGACCTAGAGGAACTCCGGTAAA -> CGACCTAGAGGAACTCCGGTAAAG
TCGTGCAGGTGTTTAGGTACACCG -> CGTGCAGGTGTTTAGGTACACCGG
CTTGATAATGCGACTTACCAAGGC -> TTGATAATGCGACTTACCAAGGCG
GATATGGAACAAACTGGTCAGTTC -> ATATGGAACAAACTGGTCAGTTCT
TATGGCTTGAGTTGAGTAGGCCCA -> ATGGCTTGAGTTGAGTAGGCCCAA
GCGAGCCTATATTAGGCGCTCCTA -> CGAGCCTATATTAGGCGCTCCTAA
AAGTCCGAGGAGCTTTGCATCTTA -> AGTCCGAGGAGCTTTGCATCTTAT
CGCGGTACGACTTGTGAATGCAAA -> GCGGTACGACTTGTGAATGCAAAA
TACTCACCGCGCCTAAAGTGGCCG -> ACTCACCGCGCCTAAAGTGGCCGT
GCTGGCCTTCGCTAGTTTCCGCGG -> CTGGCCTTCGCTAGTTTCCGCGGT
TAGTACCGAGTTCGGTAAGCAATT -> AGTACCGAGTTCGGTAAGCAATTG
ACGTATGGCTTGAGTTGAGTAGGC -> CGTATGGCTTGAGTTGAGTAGGCC
AAAGATGAATAGCCAAGGATGCGA -> AAGATGAATAGCCAAGGATGCGAA
CGTCTAAAACGACCTAGAGGAACT -> GTCTAAAACGACCTAGAGGAACTC
ACAGCTAACATGAACGCGACGCTA -> CAGCTAACATGAACGCGACGCTAT
GTTCTACACAAAACCTACGTATGG -> TTCTACACAAAACCTACGTATGGC
CGGAGAATTAAGTAATGAATCAAC -> GGAGAATTAAGTAATGAATCAACA
TAAGGTTCTGCTGTCGGGGGTTGT -> AAGGTTCTGCTGTCGGGGGTTGTA
TAGTTCCTCCCAACTTGACAGCAA -> AGTTCCTCCCAACTTGACAGCAAG
GTGTTTAGGTACACCGGTAAAAGA -> TGTTTAGGTACACCGGTAAAAGAT
ACTCTGGCGGGGCCACACAATGGA -> CTCTGGCGGGGCCACACAATGGAC
TAAACTACCTTAATATAAGATCGA -> AAACTACCTTAATATAAGATCGAG
AGTGATGGTTGTTAGAGCATTCCC -> GTGATGGTTGTTAGAGCATTCCCC
CATCGGACGGTGCGGCTCTGGCCT -> ATCGGACGGTGCGGCTCTGGCCTT
ACGCTATACTTGATACAACGCCCC -> CGCTATACTTGATACAACGCCCCT
TTGAAGACGTGGTCCGGGCTGGAA -> TGAAGACGTGGTCCGGGCTGGAAG
ACAGGCCCTGATTGAAGACGTGGT -> CAGGCCCTGATTGAAGACGTGGTC
TCCTTGCGAGCGGCCAACCTATCC -> CCTTGCGAGCGGCCAACCTATCCT
TTGGGCATCAAGTAGAGCAAATAC -> TGGGCATCAAGTAGAGCAAATACC
ATTCCATCGGACGGTGCGGCTCTG -> TTCCATCGGACGGTGCGGCTCTGG
CCTGATTGAAGACGTGGTCCGGGC -> CTGATTGAAGACGTGGTCCGGGCT
CGAAGCGGGAGCCAAGTCATAAAT -> GAAGCGGGAGCCAAGTCATAAATC
GCCCCTCACGTGGTCTTTTAATTG -> CCCCTCACGTGGTCTTTTAATTGC
AATTTCTTACGACTAGTTCCTCCC -> ATTTCTTACGACTAGTTCCTCCCA
CCATAGCGAGCCTATATTAGGCGC -> CATAGCGAGCCTATATTAGGCGCT
TGTACTCTGGCGGGGCCACACAAT -> GTACTCTGGCGGGGCCACACAATG
GATAATGCGACTTACCAAGGCGCG -> ATAATGCGACTTACCAAGGCGCGT
TGGTCAGTTCTACACAAAACCTAC -> GGTCAGTTCTACACAAAACCTACG
TGATGGTTGTTAGAGCATTCCCCA -> GATGGTTGTTAGAGCATTCCCCAA
GATTCCATCGGACGGTGCGGCTCT -> ATTCCATCGGACGGTGCGGCTCTG
CGGATCCACAGGCCCTGATTGAAG -> GGATCCACAGGCCCTGATTGAAGA
AGGCTTAGTCCACGACCTAATACT -> GGCTTAGTCCACGACCTAATACTT
AGACGCTCAGCGATGGTAAGTTAA -> GACGCTCAGCGATGGTAAGTTAAG
CGCCTGACTTTCTATAGTTATTCC -> GCCTGACTTTCTATAGTTATTCCG
AGTAATATGTTCGTAAAATAGCCG -> GTAATATGTTCGTAAAATAGCCGT
GATGTTCATAATTTCTTACGACTA -> ATGTTCATAATTTCTTACGACTAG
GGCGCTCCTAATGGCCAACTAGGG -> GCGCTCCTAATGGCCAACTAGGGC
AAACTCACAGCTAACATGAACGCG -> AACTCACAGCTAACATGAACGCGA
TTTGCATCTTATACCAACAGTGTA -> TTGCATCTTATACCAACAGTGTAC
GGCTTAGTCCACGACCTAATACTT -> GCTTAGTCCACGACCTAATACTTA
AACTGATCTCTGTACACATGCGAA -> ACTGATCTCTGTACACATGCGAAG
TTCACCACACGTCCCCGACTTAAG -> TCACCACACGTCCCCGACTTAAGG
GCCGCCCTTACGGATGGTCGAAGT -> CCGCCCTTACGGATGGTCGAAGTC
GCGGGGCCACACAATGGACCAGTG -> CGGGGCCACACAATGGACCAGTGC
AGAGGGGAAGCTAGTGATGGTTGT -> GAGGGGAAGCTAGTGATGGTTGTT
GTGGGTCAATGGCTCTGAGCTTAT -> TGGGTCAATGGCTCTGAGCTTATC
CGCTCGGTCATTACTAGAATACGT -> GCTCGGTCATTACTAGAATACGTC
TCTTACGACTAGTTCCTCCCAACT -> CTTACGACTAGTTCCTCCCAACTT
CTCGGCATTGTGCCACCATGCTCC -> TCGGCATTGTGCCACCATGCTCCT
AGGTGTTTAGGTACACCGGTAAAA -> GGTGTTTAGGTACACCGGTAAAAG
CGGCCAACCTATCCTTTAAAGGAT -> GGCCAACCTATCCTTTAAAGGATC
TAAACTCGTTGCACAACTACACTA -> AAACTCGTTGCACAACTACACTAG
TCATTACTAGAATACGTCAATTAT -> CATTACTAGAATACGTCAATTATG
CGGACGGTGCGGCTCTGGCCTTAA -> GGACGGTGCGGCTCTGGCCTTAAT
TGAACATTGTCTAATTGCCTCCAA -> GAACATTGTCTAATTGCCTCCAAA
GAAACTCACAGCTAACATGAACGC -> AAACTCACAGCTAACATGAACGCG
TCCGAGCTTTGCTGGCCTTCGCTA -> CCGAGCTTTGCTGGCCTTCGCTAG
CACGACACTTACGAGCTGCTCCGA -> ACGACACTTACGAGCTGCTCCGAT
CGACGCTATACTTGATACAACGCC -> GACGCTATACTTGATACAACGCCC
ACCAAAGGCATACTGCTGGCGAAC -> CCAAAGGCATACTGCTGGCGAACC
TTGGTCCGGCTGTACTCTGGCGGG -> TGGTCCGGCTGTACTCTGGCGGGG
ATAGTTATTCCGTAGTCTTTATGC -> TAGTTATTCCGTAGTCTTTATGCA
GAACATTGTCTAATTGCCTCCAAA -> AACATTGTCTAATTGCCTCCAAAT
GCCGTCGCGGATCCACAGGCCCTG -> CCGTCGCGGATCCACAGGCCCTGA
GCTATACTTGATACAACGCCCCTC -> CTATACTTGATACAACGCCCCTCA
TTGCAGTGGAACTATTTTACGCAT -> TGCAGTGGAACTATTTTACGCATG
TCACCACACGTCCCCGACTTAAGG -> CACCACACGTCCCCGACTTAAGGT
GTTGGGTAGTAATATGTTCGTAAA -> TTGGGTAGTAATATGTTCGTAAAA
TTACGGATGGTCGAAGTCCAGTCC -> TACGGATGGTCGAAGTCCAGTCCC
GCGTGTCCAAAAGGTGTTCAGCGA -> CGTGTCCAAAAGGTGTTCAGCGAT
GAAGACGTGGTCCGGGCTGGAAGT -> AAGACGTGGTCCGGGCTGGAAGTG
CCTTTAAAGGATCAAGCCCCAGCG -> CTTTAAAGGATCAAGCCCCAGCGC
TTAGCTGAATTGTGTTGGGTAGTA -> TAGCTGAATTGTGTTGGGTAGTAA
ACTTACGAGCTGCTCCGATCAATA -> CTTACGAGCTGCTCCGATCAATAA
AGTCCGAGGAGCTTTGCATCTTAT -> GTCCGAGGAGCTTTGCATCTTATA
ATATAAAGATATGTCGTTTGCTAA -> TATAAAGATATGTCGTTTGCTAAA
TCCGTACTCACCGCGCCTAAAGTG -> CCGTACTCACCGCGCCTAAAGTGG
GTTTCCGTACTCACCGCGCCTAAA -> TTTCCGTACTCACCGCGCCTAAAG
GATCCACAGGCCCTGATTGAAGAC -> ATCCACAGGCCCTGATTGAAGACG
CTCTACAAACGGGGTTTAGTTTAC -> TCTACAAACGGGGTTTAGTTTACA
GCCAACCTATCCTTTAAAGGATCA -> CCAACCTATCCTTTAAAGGATCAA
AATTGCCATGCCTCGTGCAAAGCT -> ATTGCCATGCCTCGTGCAAAGCTT
CCATGCCTCGTGCAAAGCTTACAA -> CATGCCTCGTGCAAAGCTTACAAT
TGATCTCTGTACACATGCGAAGCG -> GATCTCTGTACACATGCGAAGCGG
TTACTAGAATACGTCAATTATGAA -> TACTAGAATACGTCAATTATGAAG
TTGTTAGAGCATTCCCCAACCTCA -> TGTTAGAGCATTCCCCAACCTCAA
ACGCGACGCTATACTTGATACAAC -> CGCGACGCTATACTTGATACAACG
TACGAGACGCTCAGCGATGGTAAG -> ACGAGACGCTCAGCGATGGTAAGT
ATGGCTCGCACGACACTTACGAGC -> TGGCTCGCACGACACTTACGAGCT
CCTTGATAATGCGACTTACCAAGG -> CTTGATAATGCGACTTACCAAGGC
TCTACAAACGGGGTTTAGTTTACA -> CTACAAACGGGGTTTAGTTTACAG
GTCCGAGGAGCTTTGCATCTTATA -> TCCGAGGAGCTTTGCATCTTATAC
CTTATACTTGTATCGCGGGATATA -> TTATACTTGTATCGCGGGATATAA
TACAGGTGGAGCGTCTAAAACGAC -> ACAGGTGGAGCGTCTAAAACGACC
GTGATTAGAAAAGGCGCTCGGTCA -> TGATTAGAAAAGGCGCTCGGTCAT
ATGCAGCACGTCCGGTAAGTACTT -> TGCAGCACGTCCGGTAAGTACTTG
GAGTATCGATTTCCACCAGTTGCG -> AGTATCGATTTCCACCAGTTGCGA
TCCACGACCTAATACTTAACCTTC -> CCACGACCTAATACTTAACCTTCT
GGTCTCGGCATTGTGCCACCATGC -> GTCTCGGCATTGTGCCACCATGCT
GCTTAGTCCACGACCTAATACTTA -> CTTAGTCCACGACCTAATACTTAA
GTCAGTTCTACACAAAACCTACGT -> TCAGTTCTACACAAAACCTACGTA
ACACGTCCCCGACTTAAGGTTCTG -> CACGTCCCCGACTTAAGGTTCTGC
AGGCTCTTCCGTTCCGATATGGAA -> GGCTCTTCCGTTCCGATATGGAAC
GTCTTTTAATTGCGCACGTAAAAT -> TCTTTTAATTGCGCACGTAAAATT
GTGCCACCATGCTCCTTGCGAGCG -> TGCCACCATGCTCCTTGCGAGCGG
CGAGGCTTAGTCCACGACCTAATA -> GAGGCTTAGTCCACGACCTAATAC
CCCCAGCGCCGAGGTGCCTCACTT -> CCCAGCGCCGAGGTGCCTCACTTA
TTACAGTGATTATAGGCAGGTTAG -> TACAGTGATTATAGGCAGGTTAGT
CTAGGGCTGACGCTCGTCTATTTT -> TAGGGCTGACGCTCGTCTATTTTA
CTGGAGAACCAAGCGGAGAATTAA -> TGGAGAACCAAGCGGAGAATTAAG
ACTTGCCCAACGGCTTACCTAGGA -> CTTGCCCAACGGCTTACCTAGGAG
AGGGACCTTATACTTGTATCGCGG -> GGGACCTTATACTTGTATCGCGGG
GTTGTAGGGGTGCATAGACGGCTG -> TTGTAGGGGTGCATAGACGGCTGT
CGACTAGTAAACTCGTTGCACAAC -> GACTAGTAAACTCGTTGCACAACT
GTAGGGGTGCATAGACGGCTGTGT -> TAGGGGTGCATAGACGGCTGTGTA
GGATATAAACACTGGAGAACCAAG -> GATATAAACACTGGAGAACCAAGC
CGTTGCACAACTACACTAGGGCTG -> GTTGCACAACTACACTAGGGCTGA
TCAGAATTCTTGCAGTGGAACTAT -> CAGAATTCTTGCAGTGGAACTATT
CGTAAAATTTCCGAGCTTTGCTGG -> GTAAAATTTCCGAGCTTTGCTGGC
CTAGAGGAACTCCGGTAAAGCAAT -> TAGAGGAACTCCGGTAAAGCAATC
GGATTCTCTACAAACGGGGTTTAG -> GATTCTCTACAAACGGGGTTTAGT
AATAGCCAAGGATGCGAAGGATCT -> ATAGCCAAGGATGCGAAGGATCTC
GGCGCCTTGATAATGCGACTTACC -> GCGCCTTGATAATGCGACTTACCA
CTCGGTCATTACTAGAATACGTCA -> TCGGTCATTACTAGAATACGTCAA
GGTAAGTTAAGTCCGAGGAGCTTT -> GTAAGTTAAGTCCGAGGAGCTTTG
TCTGAGCTTATCCGCCGATCGGGA -> CTGAGCTTATCCGCCGATCGGGAT
AGCGTCTAAAACGACCTAGAGGAA -> GCGTCTAAAACGACCTAGAGGAAC
AGGAAACTCACAGCTAACATGAAC -> GGAAACTCACAGCTAACATGAACG
AAAGATATGTCGTTTGCTAAACTA -> AAGATATGTCGTTTGCTAAACTAC
ATAAGATCGAGGCTTAGTCCACGA -> TAAGATCGAGGCTTAGTCCACGAC
GCACGACACTTACGAGCTGCTCCG -> CACGACACTTACGAGCTGCTCCGA
GAACCCTAGTAGGCTCTTCCGTTC -> AACCCTAGTAGGCTCTTCCGTTCC
GAATCTCGGATCCCTAGATTCCAT -> AATCTCGGATCCCTAGATTCCATA
TCCATAGCGAGCCTATATTAGGCG -> CCATAGCGAGCCTATATTAGGCGC
GTGCATAGACGGCTGTGTAAAGTT -> TGCATAGACGGCTGTGTAAAGTTT
TCAATGGCTCTGAGCTTATCCGCC -> CAATGGCTCTGAGCTTATCCGCCG
GGGATATAAACACTGGAGAACCAA -> GGATATAAACACTGGAGAACCAAG
CTATACTTGATACAACGCCCCTCA -> TATACTTGATACAACGCCCCTCAC
ACAACGCCCCTCACGTGGTCTTTT -> CAACGCCCCTCACGTGGTCTTTTA
CGTTTCACCACACGTCCCCGACTT -> GTTTCACCACACGTCCCCGACTTA
CTCTGAGCTTATCCGCCGATCGGG -> TCTGAGCTTATCCGCCGATCGGGA
GGCTCTGGCCTTAATGCATGGCTC -> GCTCTGGCCTTAATGCATGGCTCG
TGCCTCCAAATTTACATTGGTCCG -> GCCTCCAAATTTACATTGGTCCGG
TATATTAGGCGCTCCTAATGGCCA -> ATATTAGGCGCTCCTAATGGCCAA
GCCGTGATTAGAAAAGGCGCTCGG -> CCGTGATTAGAAAAGGCGCTCGGT
GACATTAGCTGAATTGTGTTGGGT -> ACATTAGCTGAATTGTGTTGGGTA
AACGCGACGCTATACTTGATACAA -> ACGCGACGCTATACTTGATACAAC
CGCACGACACTTACGAGCTGCTCC -> GCACGACACTTACGAGCTGCTCCG
ACCAGTTGCGAGGACAGGAATCTC -> CCAGTTGCGAGGACAGGAATCTCG
TTGATACAACGCCCCTCACGTGGT -> TGATACAACGCCCCTCACGTGGTC
GACGCTCAGCGATGGTAAGTTAAG -> ACGCTCAGCGATGGTAAGTTAAGT
CTCCTTGCGAGCGGCCAACCTATC -> TCCTTGCGAGCGGCCAACCTATCC
TGGCTTGAGTTGAGTAGGCCCAAT -> GGCTTGAGTTGAGTAGGCCCAATG
AGTCTTTATGCAGCACGTCCGGTA -> GTCTTTATGCAGCACGTCCGGTAA
CAGTGTACCAAAGGCATACTGCTG -> AGTGTACCAAAGGCATACTGCTGG
TACTTGACGTTTCCGTACTCACCG -> ACTTGACGTTTCCGTACTCACCGC
AGCTGCTCCGATCAATAACTGATC -> GCTGCTCCGATCAATAACTGATCT
CATTCCCCAACCTCAAGCATAGAG -> ATTCCCCAACCTCAAGCATAGAGT
AAGCGGAGAATTAAGTAATGAATC -> AGCGGAGAATTAAGTAATGAATCA
TTCATGTTATCCACTTGCCCAACG -> TCATGTTATCCACTTGCCCAACGG
GATTAGAAAAGGCGCTCGGTCATT -> ATTAGAAAAGGCGCTCGGTCATTA
CGTGGGTCAATGGCTCTGAGCTTA -> GTGGGTCAATGGCTCTGAGCTTAT
TCTCTACAAACGGGGTTTAGTTTA -> CTCTACAAACGGGGTTTAGTTTAC
TTTCTTACGACTAGTTCCTCCCAA -> TTCTTACGACTAGTTCCTCCCAAC
GTTGCGAGGACAGGAATCTCGGAT -> TTGCGAGGACAGGAATCTCGGATC
GCATCAAGTAGAGCAAATACCCGC -> CATCAAGTAGAGCAAATACCCGCT
ATGGCTCTGAGCTTATCCGCCGAT -> TGGCTCTGAGCTTATCCGCCGATC
GCATAGACGGCTGTGTAAAGTTTG -> CATAGACGGCTGTGTAAAGTTTGA
CGCGACGCTATACTTGATACAACG -> GCGACGCTATACTTGATACAACGC
TAATGAATCAACACTGATTCCTGG -> AATGAATCAACACTGATTCCTGGT
TAAACACTGGAGAACCAAGCGGAG -> AAACACTGGAGAACCAAGCGGAGA
AAACCTACGTATGGCTTGAGTTGA -> AACCTACGTATGGCTTGAGTTGAG
GCATGCGAGACATTAGCTGAATTG -> CATGCGAGACATTAGCTGAATTGT
TGCGAAGCGGGAGCCAAGTCATAA -> GCGAAGCGGGAGCCAAGTCATAAA
CTAAAGTGGCCGTATTGGTATAAA -> TAAAGTGGCCGTATTGGTATAAAG
ATCTCCGGGCGCGATGGCCGGACA -> TCTCCGGGCGCGATGGCCGGACAT
TCCCTAGATTCCATAGCGAGCCTA -> CCCTAGATTCCATAGCGAGCCTAT
AAGCGGGAGCCAAGTCATAAATCC -> AGCGGGAGCCAAGTCATAAATCCG
TTCTGCTGTCGGGGGTTGTAGGGG -> TCTGCTGTCGGGGGTTGTAGGGGT
CTCACTTAACGGGGAATGCAGGAG -> TCACTTAACGGGGAATGCAGGAGG
CGACACTTACGAGCTGCTCCGATC -> GACACTTACGAGCTGCTCCGATCA
GGGAATGCAGGAGGAACGATGTTC -> GGAATGCAGGAGGAACGATGTTCA
GCGCTCCTAATGGCCAACTAGGGC -> CGCTCCTAATGGCCAACTAGGGCG
GGTAAAAGATGAATAGCCAAGGAT -> GTAAAAGATGAATAGCCAAGGATG
GGACGACTAGTAAACTCGTTGCAC -> GACGACTAGTAAACTCGTTGCACA
ATTGTGCCACCATGCTCCTTGCGA -> TTGTGCCACCATGCTCCTTGCGAG
TACCAACAGTGTACCAAAGGCATA -> ACCAACAGTGTACCAAAGGCATAC
GATATAAACACTGGAGAACCAAGC -> ATATAAACACTGGAGAACCAAGCG
AATGCATGGCTCGCACGACACTTA -> ATGCATGGCTCGCACGACACTTAC
AAGCATAGAGTATCGATTTCCACC -> AGCATAGAGTATCGATTTCCACCA
ACCTTATACTTGTATCGCGGGATA -> CCTTATACTTGTATCGCGGGATAT
AGGATCAAGCCCCAGCGCCGAGGT -> GGATCAAGCCCCAGCGCCGAGGTG
TAATTTCTTACGACTAGTTCCTCC -> AATTTCTTACGACTAGTTCCTCCC
ATTGGTATAAAGATCCCCCCTATA -> TTGGTATAAAGATCCCCCCTATAC
CGTCGCGGATCCACAGGCCCTGAT -> GTCGCGGATCCACAGGCCCTGATT
ACTACCTTAATATAAGATCGAGGC -> CTACCTTAATATAAGATCGAGGCT
ATCAAGCCCCAGCGCCGAGGTGCC -> TCAAGCCCCAGCGCCGAGGTGCCT
TTTTGGGCATCAAGTAGAGCAAAT -> TTTGGGCATCAAGTAGAGCAAATA
TCGTCTCTTTTCGTCGTATGAGTA -> CGTCTCTTTTCGTCGTATGAGTAG
TGTTCATAATTTCTTACGACTAGT -> GTTCATAATTTCTTACGACTAGTT
GGCGAAATCGTCTCTTTTCGTCGT -> GCGAAATCGTCTCTTTTCGTCGTA
TATCGATTTCCACCAGTTGCGAGG -> ATCGATTTCCACCAGTTGCGAGGA
AACCTATCCTTTAAAGGATCAAGC -> ACCTATCCTTTAAAGGATCAAGCC
CGCTTTTCATTAGGAAACTCACAG -> GCTTTTCATTAGGAAACTCACAGC
TCTGCTGTCGGGGGTTGTAGGGGT -> CTGCTGTCGGGGGTTGTAGGGGTG
AGTCATAAATCCGCCTGACTTTCT -> GTCATAAATCCGCCTGACTTTCTA
TGATAATGCGACTTACCAAGGCGC -> GATAATGCGACTTACCAAGGCGCG
ATTCCGTAGTCTTTATGCAGCACG -> TTCCGTAGTCTTTATGCAGCACGT
CTTAACCTTCTCTCCGCTGAGCGC -> TTAACCTTCTCTCCGCTGAGCGCG
TTCTACACAAAACCTACGTATGGC -> TCTACACAAAACCTACGTATGGCT
GCTTTGCATCTTATACCAACAGTG -> CTTTGCATCTTATACCAACAGTGT
ATATGGAACAAACTGGTCAGTTCT -> TATGGAACAAACTGGTCAGTTCTA
GCATTACAGGTGGAGCGTCTAAAA -> CATTACAGGTGGAGCGTCTAAAAC
TACAGTGATTATAGGCAGGTTAGT -> ACAGTGATTATAGGCAGGTTAGTG
CCTTAATATAAGATCGAGGCTTAG -> CTTAATATAAGATCGAGGCTTAGT
CCGTAGTCTTTATGCAGCACGTCC -> CGTAGTCTTTATGCAGCACGTCCG
TAAAGTTTGACAGGCGCCTTGATA -> AAAGTTTGACAGGCGCCTTGATAA
TTAACCTTCTCTCCGCTGAGCGCG -> TAACCTTCTCTCCGCTGAGCGCGT
CCGCCCTTACGGATGGTCGAAGTC -> CGCCCTTACGGATGGTCGAAGTCC
GTGGTCTTTTAATTGCGCACGTAA -> TGGTCTTTTAATTGCGCACGTAAA
GACTTACCAAGGCGCGTGTCCAAA -> ACTTACCAAGGCGCGTGTCCAAAA
GATTCCTGGTCTCGGCATTGTGCC -> ATTCCTGGTCTCGGCATTGTGCCA
ACCAAGGCGCGTGTCCAAAAGGTG -> CCAAGGCGCGTGTCCAAAAGGTGT
GTCTTTATGCAGCACGTCCGGTAA -> TCTTTATGCAGCACGTCCGGTAAG
AACCCTAGTAGGCTCTTCCGTTCC -> ACCCTAGTAGGCTCTTCCGTTCCG
GGCTCTTCCGTTCCGATATGGAAC -> GCTCTTCCGTTCCGATATGGAACA
GGGGTTTAGTTTACAGTGATTATA -> GGGTTTAGTTTACAGTGATTATAG
AGCTAGTGATGGTTGTTAGAGCAT -> GCTAGTGATGGTTGTTAGAGCATT
TTGCGAGCGGCCAACCTATCCTTT -> TGCGAGCGGCCAACCTATCCTTTA
GACTGGGACGACTAGTAAACTCGT -> ACTGGGACGACTAGTAAACTCGTT
TAAATCCGCCTGACTTTCTATAGT -> AAATCCGCCTGACTTTCTATAGTT
GTAGAGCAAATACCCGCTTTTCAT -> TAGAGCAAATACCCGCTTTTCATT
CATCCAGCTCTATGTATAGCAATT -> ATCCAGCTCTATGTATAGCAATTT
GTGTACCAAAGGCATACTGCTGGC -> TGTACCAAAGGCATACTGCTGGCG
GACTAGTAAACTCGTTGCACAACT -> ACTAGTAAACTCGTTGCACAACTA
GTATAGCAATTTCATGTTATCCAC -> TATAGCAATTTCATGTTATCCACT
CCCGACTTAAGGTTCTGCTGTCGG -> CCGACTTAAGGTTCTGCTGTCGGG
CAAATACCCGCTTTTCATTAGGAA -> AAATACCCGCTTTTCATTAGGAAA
GAAAAGGCGCTCGGTCATTACTAG -> AAAAGGCGCTCGGTCATTACTAGA
GGAGTCCCACGTGGGTCAATGGCT -> GAGTCCCACGTGGGTCAATGGCTC
GCTCTTCCGTTCCGATATGGAACA -> CTCTTCCGTTCCGATATGGAACAA
TCCCACGTGGGTCAATGGCTCTGA -> CCCACGTGGGTCAATGGCTCTGAG
TAATATGTTCGTAAAATAGCCGTC -> AATATGTTCGTAAAATAGCCGTCG
TTGTGCCACCATGCTCCTTGCGAG -> TGTGCCACCATGCTCCTTGCGAGC
CATTGTCTAATTGCCTCCAAATTT -> ATTGTCTAATTGCCTCCAAATTTA
CAAAGCTTACAATGCAGCCAAGCT -> AAAGCTTACAATGCAGCCAAGCTC
TTGATAATGCGACTTACCAAGGCG -> TGATAATGCGACTTACCAAGGCGC
GTAGGCCCAATGCGGCCGCCCTTA -> TAGGCCCAATGCGGCCGCCCTTAC
ACACAATGGACCAGTGCTAGTTCA -> CACAATGGACCAGTGCTAGTTCAG
CTGCTGTCGGGGGTTGTAGGGGTG -> TGCTGTCGGGGGTTGTAGGGGTGC
GGAAGTGTCGGCCGTGATTAGAAA -> GAAGTGTCGGCCGTGATTAGAAAA
TTGACAGGCGCCTTGATAATGCGA -> TGACAGGCGCCTTGATAATGCGAC
GACCTTATACTTGTATCGCGGGAT -> ACCTTATACTTGTATCGCGGGATA
GTTATCCACTTGCCCAACGGCTTA -> TTATCCACTTGCCCAACGGCTTAC
GGCCCTGATTGAAGACGTGGTCCG -> GCCCTGATTGAAGACGTGGTCCGG
AAGGCATACTGCTGGCGAACCCTA -> AGGCATACTGCTGGCGAACCCTAG
GGATCCACGCCGTGTATATAAAGA -> GATCCACGCCGTGTATATAAAGAT
AATAGCCGTCGCGGATCCACAGGC -> ATAGCCGTCGCGGATCCACAGGCC
TTAGTGCGCATTACAGGTGGAGCG -> TAGTGCGCATTACAGGTGGAGCGT
TATACCAACAGTGTACCAAAGGCA -> ATACCAACAGTGTACCAAAGGCAT
CATGCGAGACATTAGCTGAATTGT -> ATGCGAGACATTAGCTGAATTGTG
TACGACTTGTGAATGCAAAAGCCA -> ACGACTTGTGAATGCAAAAGCCAT
GTGTAAAGTTTGACAGGCGCCTTG -> TGTAAAGTTTGACAGGCGCCTTGA
CCTAATACTTAACCTTCTCTCCGC -> CTAATACTTAACCTTCTCTCCGCT
GGCATCAAGTAGAGCAAATACCCG -> GCATCAAGTAGAGCAAATACCCGC
CTACACTAGGGCTGACGCTCGTCT -> TACACTAGGGCTGACGCTCGTCTA
GAACTATTTTACGCATGCGAGACA -> AACTATTTTACGCATGCGAGACAT
CGGGCGCGATGGCCGGACATAGAG -> GGGCGCGATGGCCGGACATAGAGG
TGCTCCTTGCGAGCGGCCAACCTA -> GCTCCTTGCGAGCGGCCAACCTAT
CTCTGTACACATGCGAAGCGGGAG -> TCTGTACACATGCGAAGCGGGAGC
CGCCGAGGTGCCTCACTTAACGGG -> GCCGAGGTGCCTCACTTAACGGGG
AGGCCCAATGCGGCCGCCCTTACG -> GGCCCAATGCGGCCGCCCTTACGG
ACAGCAAGACTGGGACGACTAGTA -> CAGCAAGACTGGGACGACTAGTAA
CATAGAGGGGAAGCTAGTGATGGT -> ATAGAGGGGAAGCTAGTGATGGTT
TAGGAAACTCACAGCTAACATGAA -> AGGAAACTCACAGCTAACATGAAC
ATCTCTGTACACATGCGAAGCGGG -> TCTCTGTACACATGCGAAGCGGGA
ACAAACTGGTCAGTTCTACACAAA -> CAAACTGGTCAGTTCTACACAAAA
CGGGGCCACACAATGGACCAGTGC -> GGGGCCACACAATGGACCAGTGCT
TCCAGCTCTATGTATAGCAATTTC -> CCAGCTCTATGTATAGCAATTTCA
CACGTGGTCTTTTAATTGCGCACG -> ACGTGGTCTTTTAATTGCGCACGT
TCTGTACACATGCGAAGCGGGAGC -> CTGTACACATGCGAAGCGGGAGCC
GTGAACATTGTCTAATTGCCTCCA -> TGAACATTGTCTAATTGCCTCCAA
TTCCACCAGTTGCGAGGACAGGAA -> TCCACCAGTTGCGAGGACAGGAAT
TAAGTTAAGTCCGAGGAGCTTTGC -> AAGTTAAGTCCGAGGAGCTTTGCA
AGCCAAGGATGCGAAGGATCTCAC -> GCCAAGGATGCGAAGGATCTCACG
GGACCTTATACTTGTATCGCGGGA -> GACCTTATACTTGTATCGCGGGAT
TAAAAGATGAATAGCCAAGGATGC -> AAAAGATGAATAGCCAAGGATGCG
ATTTCCACCAGTTGCGAGGACAGG -> TTTCCACCAGTTGCGAGGACAGGA
CCCCTCACGTGGTCTTTTAATTGC -> CCCTCACGTGGTCTTTTAATTGCG
AATGCGACTTACCAAGGCGCGTGT -> ATGCGACTTACCAAGGCGCGTGTC
AAAGTGGCCGTATTGGTATAAAGA -> AAGTGGCCGTATTGGTATAAAGAT
TCTCCGGGCGCGATGGCCGGACAT -> CTCCGGGCGCGATGGCCGGACATA
GGAATCTCGGATCCCTAGATTCCA -> GAATCTCGGATCCCTAGATTCCAT
CACGTCCGGTAAGTACTTGACGTT -> ACGTCCGGTAAGTACTTGACGTTT
ACAGGTGGAGCGTCTAAAACGACC -> CAGGTGGAGCGTCTAAAACGACCT
CCTTACGGATGGTCGAAGTCCAGT -> CTTACGGATGGTCGAAGTCCAGTC
CGTTTGCTAAACTACCTTAATATA -> GTTTGCTAAACTACCTTAATATAA
TGCCACCATGCTCCTTGCGAGCGG -> GCCACCATGCTCCTTGCGAGCGGC
AGTATCGATTTCCACCAGTTGCGA -> GTATCGATTTCCACCAGTTGCGAG
CTAAACTACCTTAATATAAGATCG -> TAAACTACCTTAATATAAGATCGA
CAGTTCTACACAAAACCTACGTAT -> AGTTCTACACAAAACCTACGTATG
CGATCAATAACTGATCTCTGTACA -> GATCAATAACTGATCTCTGTACAC
GGTTGTTAGAGCATTCCCCAACCT -> GTTGTTAGAGCATTCCCCAACCTC
CAAAAGGTGTTCAGCGATTCCATC -> AAAAGGTGTTCAGCGATTCCATCG
ACAGTGTACCAAAGGCATACTGCT -> CAGTGTACCAAAGGCATACTGCTG
CGAGACGCTCAGCGATGGTAAGTT -> GAGACGCTCAGCGATGGTAAGTTA
CCACGTGGGTCAATGGCTCTGAGC -> CACGTGGGTCAATGGCTCTGAGCT
CATAATTTCTTACGACTAGTTCCT -> ATAATTTCTTACGACTAGTTCCTC
GTGCAAAGCTTACAATGCAGCCAA -> TGCAAAGCTTACAATGCAGCCAAG
ATAGCCAAGGATGCGAAGGATCTC -> TAGCCAAGGATGCGAAGGATCTCA
CGTATTGGTATAAAGATCCCCCCT -> GTATTGGTATAAAGATCCCCCCTA
TCCGGTAAGTACTTGACGTTTCCG -> CCGGTAAGTACTTGACGTTTCCGT
CGAAATCGTCTCTTTTCGTCGTAT -> GAAATCGTCTCTTTTCGTCGTATG
GCTTATCCGCCGATCGGGATCCAC -> CTTATCCGCCGATCGGGATCCACG
GTTTAGTTTACAGTGATTATAGGC -> TTTAGTTTACAGTGATTATAGGCA
CGTAGTCTTTATGCAGCACGTCCG -> GTAGTCTTTATGCAGCACGTCCGG
CTGGCGAACCCTAGTAGGCTCTTC -> TGGCGAACCCTAGTAGGCTCTTCC
CGCCTAAAGTGGCCGTATTGGTAT -> GCCTAAAGTGGCCGTATTGGTATA
CGGGATCCACGCCGTGTATATAAA -> GGGATCCACGCCGTGTATATAAAG
GCTTTGCTGGCCTTCGCTAGTTTC -> CTTTGCTGGCCTTCGCTAGTTTCC
CGTGGTCTTTTAATTGCGCACGTA -> GTGGTCTTTTAATTGCGCACGTAA
TGGAACTATTTTACGCATGCGAGA -> GGAACTATTTTACGCATGCGAGAC
TAAAATTTCCGAGCTTTGCTGGCC -> AAAATTTCCGAGCTTTGCTGGCCT
CGGCCGTGATTAGAAAAGGCGCTC -> GGCCGTGATTAGAAAAGGCGCTCG
AAGCTTACAATGCAGCCAAGCTCG -> AGCTTACAATGCAGCCAAGCTCGA
CTCACCGCGCCTAAAGTGGCCGTA -> TCACCGCGCCTAAAGTGGCCGTAT
CGGTGCGGCTCTGGCCTTAATGCA -> GGTGCGGCTCTGGCCTTAATGCAT
GATTATAGGCAGGTTAGTGCGCAT -> ATTATAGGCAGGTTAGTGCGCATT
ATTTTGGGCATCAAGTAGAGCAAA -> TTTTGGGCATCAAGTAGAGCAAAT
GTCCGGCTGTACTCTGGCGGGGCC -> TCCGGCTGTACTCTGGCGGGGCCA
GCTGGAAGTGTCGGCCGTGATTAG -> CTGGAAGTGTCGGCCGTGATTAGA
GGACATAGAGGGGAAGCTAGTGAT -> GACATAGAGGGGAAGCTAGTGATG
GAGTTCGGTAAGCAATTGCCATGC -> AGTTCGGTAAGCAATTGCCATGCC
GCTGACGCTCGTCTATTTTACGGA -> CTGACGCTCGTCTATTTTACGGAT
GCCTGACTTTCTATAGTTATTCCG -> CCTGACTTTCTATAGTTATTCCGT
CGATGTTCATAATTTCTTACGACT -> GATGTTCATAATTTCTTACGACTA
TAGACGGCTGTGTAAAGTTTGACA -> AGACGGCTGTGTAAAGTTTGACAG
TGTCTAATTGCCTCCAAATTTACA -> GTCTAATTGCCTCCAAATTTACAT
ACGTTTCCGTACTCACCGCGCCTA -> CGTTTCCGTACTCACCGCGCCTAA
TACGACTAGTTCCTCCCAACTTGA -> ACGACTAGTTCCTCCCAACTTGAC
ATAAACACTGGAGAACCAAGCGGA -> TAAACACTGGAGAACCAAGCGGAG
ACGACTTGTGAATGCAAAAGCCAT -> CGACTTGTGAATGCAAAAGCCATT
TACCTTAATATAAGATCGAGGCTT -> ACCTTAATATAAGATCGAGGCTTA
ATACCAACAGTGTACCAAAGGCAT -> TACCAACAGTGTACCAAAGGCATA
GATCAAGCCCCAGCGCCGAGGTGC -> ATCAAGCCCCAGCGCCGAGGTGCC
GTACGACTTGTGAATGCAAAAGCC -> TACGACTTGTGAATGCAAAAGCCA
TCCGTAGTCTTTATGCAGCACGTC -> CCGTAGTCTTTATGCAGCACGTCC
GAGGACAGGAATCTCGGATCCCTA -> AGGACAGGAATCTCGGATCCCTAG
TCACTTAACGGGGAATGCAGGAGG -> CACTTAACGGGGAATGCAGGAGGA
ACGCCCCTCACGTGGTCTTTTAAT -> CGCCCCTCACGTGGTCTTTTAATT
CCTTGCGAGCGGCCAACCTATCCT -> CTTGCGAGCGGCCAACCTATCCTT
AGCCAAGCTCGAGAATCTCCGGGC -> GCCAAGCTCGAGAATCTCCGGGCG
AAATACCCGCTTTTCATTAGGAAA -> AATACCCGCTTTTCATTAGGAAAC
GCGCTCGGTCATTACTAGAATACG -> CGCTCGGTCATTACTAGAATACGT
TGGTCCGGGCTGGAAGTGTCGGCC -> GGTCCGGGCTGGAAGTGTCGGCCG
AGAGCATTCCCCAACCTCAAGCAT -> GAGCATTCCCCAACCTCAAGCATA
CATACTGCTGGCGAACCCTAGTAG -> ATACTGCTGGCGAACCCTAGTAGG
GCTAGTTTCCGCGGTACGACTTGT -> CTAGTTTCCGCGGTACGACTTGTG
ATATTAGGCGCTCCTAATGGCCAA -> TATTAGGCGCTCCTAATGGCCAAC
GCACAACTACACTAGGGCTGACGC -> CACAACTACACTAGGGCTGACGCT
ACCGGTAAAAGATGAATAGCCAAG -> CCGGTAAAAGATGAATAGCCAAGG
TTCTTACGACTAGTTCCTCCCAAC -> TCTTACGACTAGTTCCTCCCAACT
ACCAGTGCTAGTTCAGAATTCTTG -> CCAGTGCTAGTTCAGAATTCTTGC
ATGCAGGAGGAACGATGTTCATAA -> TGCAGGAGGAACGATGTTCATAAT
GAGCGCGTAGGAGCTTTTAGTACC -> AGCGCGTAGGAGCTTTTAGTACCG
AGCGCGTAGGAGCTTTTAGTACCG -> GCGCGTAGGAGCTTTTAGTACCGA
GGGTCAATGGCTCTGAGCTTATCC -> GGTCAATGGCTCTGAGCTTATCCG
AAGATCCCCCCTATACGAGACGCT -> AGATCCCCCCTATACGAGACGCTC
ACGCTCAGCGATGGTAAGTTAAGT -> CGCTCAGCGATGGTAAGTTAAGTC
GCCTTAATGCATGGCTCGCACGAC -> CCTTAATGCATGGCTCGCACGACA
GGCGGGGCCACACAATGGACCAGT -> GCGGGGCCACACAATGGACCAGTG
CCCCAACCTCAAGCATAGAGTATC -> CCCAACCTCAAGCATAGAGTATCG
ACGCTCGTCTATTTTACGGATTCT -> CGCTCGTCTATTTTACGGATTCTC
GTCATTACTAGAATACGTCAATTA -> TCATTACTAGAATACGTCAATTAT
TCATAAATCCGCCTGACTTTCTAT -> CATAAATCCGCCTGACTTTCTATA
ATTACTAGAATACGTCAATTATGA -> TTACTAGAATACGTCAATTATGAA
TCACGTGGTCTTTTAATTGCGCAC -> CACGTGGTCTTTTAATTGCGCACG
GTGAATGCAAAAGCCATTGGCCCT -> TGAATGCAAAAGCCATTGGCCCTT
AGATTCCATAGCGAGCCTATATTA -> GATTCCATAGCGAGCCTATATTAG
CCTCAAGCATAGAGTATCGATTTC -> CTCAAGCATAGAGTATCGATTTCC
TATTTTACGCATGCGAGACATTAG -> ATTTTACGCATGCGAGACATTAGC
AATATAAGATCGAGGCTTAGTCCA -> ATATAAGATCGAGGCTTAGTCCAC
GTACTCTGGCGGGGCCACACAATG -> TACTCTGGCGGGGCCACACAATGG
ACTACACTAGGGCTGACGCTCGTC -> CTACACTAGGGCTGACGCTCGTCT
TTGCACAACTACACTAGGGCTGAC -> TGCACAACTACACTAGGGCTGACG
TTAGAAAAGGCGCTCGGTCATTAC -> TAGAAAAGGCGCTCGGTCATTACT
CAACGGCTTACCTAGGAGTCCCAC -> AACGGCTTACCTAGGAGTCCCACG
GCCTCCAAATTTACATTGGTCCGG -> CCTCCAAATTTACATTGGTCCGGC
GGTCAGTTCTACACAAAACCTACG -> GTCAGTTCTACACAAAACCTACGT
TCTCTTTTCGTCGTATGAGTAGTG -> CTCTTTTCGTCGTATGAGTAGTGT
GGCCGGACATAGAGGGGAAGCTAG -> GCCGGACATAGAGGGGAAGCTAGT
TATAGGCAGGTTAGTGCGCATTAC -> ATAGGCAGGTTAGTGCGCATTACA
GGTTTAGTTTACAGTGATTATAGG -> GTTTAGTTTACAGTGATTATAGGC
CCAACTTGACAGCAAGACTGGGAC -> CAACTTGACAGCAAGACTGGGACG
TTACGACTAGTTCCTCCCAACTTG -> TACGACTAGTTCCTCCCAACTTGA
CTGATTCCTGGTCTCGGCATTGTG -> TGATTCCTGGTCTCGGCATTGTGC
TCGTAAAATAGCCGTCGCGGATCC -> CGTAAAATAGCCGTCGCGGATCCA
GCGCACGTAAAATTTCCGAGCTTT -> CGCACGTAAAATTTCCGAGCTTTG
CCGGGCTGGAAGTGTCGGCCGTGA -> CGGGCTGGAAGTGTCGGCCGTGAT
AAAAGGTGTTCAGCGATTCCATCG -> AAAGGTGTTCAGCGATTCCATCGG
GTCTCGGCATTGTGCCACCATGCT -> TCTCGGCATTGTGCCACCATGCTC
TAGAATACGTCAATTATGAAGCTC -> AGAATACGTCAATTATGAAGCTCT
CCCTTACGGATGGTCGAAGTCCAG -> CCTTACGGATGGTCGAAGTCCAGT
AGCTTTGCTGGCCTTCGCTAGTTT -> GCTTTGCTGGCCTTCGCTAGTTTC
CCTAGAGGAACTCCGGTAAAGCAA -> CTAGAGGAACTCCGGTAAAGCAAT
GCGAGGACAGGAATCTCGGATCCC -> CGAGGACAGGAATCTCGGATCCCT
AATAACTGATCTCTGTACACATGC -> ATAACTGATCTCTGTACACATGCG
GCGAGTTAATTTTGGGCATCAAGT -> CGAGTTAATTTTGGGCATCAAGTA
CTTATACCAACAGTGTACCAAAGG -> TTATACCAACAGTGTACCAAAGGC
CTTAACGGGGAATGCAGGAGGAAC -> TTAACGGGGAATGCAGGAGGAACG
CTTTGCTGGCCTTCGCTAGTTTCC -> TTTGCTGGCCTTCGCTAGTTTCCG
ATACAACGCCCCTCACGTGGTCTT -> TACAACGCCCCTCACGTGGTCTTT
TACCCGCTTTTCATTAGGAAACTC -> ACCCGCTTTTCATTAGGAAACTCA
TACTAGAATACGTCAATTATGAAG -> ACTAGAATACGTCAATTATGAAGC
CGTAGGAGCTTTTAGTACCGAGTT -> GTAGGAGCTTTTAGTACCGAGTTC
CCAGTCCCGCGAGTTAATTTTGGG -> CAGTCCCGCGAGTTAATTTTGGGC
TGCATGGCTCGCACGACACTTACG -> GCATGGCTCGCACGACACTTACGA
CACTTGCCCAACGGCTTACCTAGG -> ACTTGCCCAACGGCTTACCTAGGA
GGTAAAGCAATCCGGCTCATCCAG -> GTAAAGCAATCCGGCTCATCCAGC
CGTATGAGTAGTGTTCGTGCAGGT -> GTATGAGTAGTGTTCGTGCAGGTG
TAGGCGCTCCTAATGGCCAACTAG -> AGGCGCTCCTAATGGCCAACTAGG
AAGTCATAAATCCGCCTGACTTTC -> AGTCATAAATCCGCCTGACTTTCT
TTGTATCGCGGGATATAAACACTG -> TGTATCGCGGGATATAAACACTGG
GCTGTACTCTGGCGGGGCCACACA -> CTGTACTCTGGCGGGGCCACACAA
GAGTTGAGTAGGCCCAATGCGGCC -> AGTTGAGTAGGCCCAATGCGGCCG
CAAGTAGAGCAAATACCCGCTTTT -> AAGTAGAGCAAATACCCGCTTTTC
TGTGTTGGGTAGTAATATGTTCGT -> GTGTTGGGTAGTAATATGTTCGTA
TAACCTTCTCTCCGCTGAGCGCGT -> AACCTTCTCTCCGCTGAGCGCGTA
AGTAGAGCAAATACCCGCTTTTCA -> GTAGAGCAAATACCCGCTTTTCAT
CCCAACGGCTTACCTAGGAGTCCC -> CCAACGGCTTACCTAGGAGTCCCA
GTTCGTGCAGGTGTTTAGGTACAC -> TTCGTGCAGGTGTTTAGGTACACC
TGCTGGCCTTCGCTAGTTTCCGCG -> GCTGGCCTTCGCTAGTTTCCGCGG
TGTATAGCAATTTCATGTTATCCA -> GTATAGCAATTTCATGTTATCCAC
CGGGAGCCAAGTCATAAATCCGCC -> GGGAGCCAAGTCATAAATCCGCCT
GCTTGAGTTGAGTAGGCCCAATGC -> CTTGAGTTGAGTAGGCCCAATGCG
GCAAATACCCGCTTTTCATTAGGA -> CAAATACCCGCTTTTCATTAGGAA
ATTAGCTGAATTGTGTTGGGTAGT -> TTAGCTGAATTGTGTTGGGTAGTA
GCGAGACATTAGCTGAATTGTGTT -> CGAGACATTAGCTGAATTGTGTTG
TAGTAGGCTCTTCCGTTCCGATAT -> AGTAGGCTCTTCCGTTCCGATATG
ACATTGTCTAATTGCCTCCAAATT -> CATTGTCTAATTGCCTCCAAATTT
TAATTGCGCACGTAAAATTTCCGA -> AATTGCGCACGTAAAATTTCCGAG
AACGCCCCTCACGTGGTCTTTTAA -> ACGCCCCTCACGTGGTCTTTTAAT
TGATTCCTGGTCTCGGCATTGTGC -> GATTCCTGGTCTCGGCATTGTGCC
TAGCTGAATTGTGTTGGGTAGTAA -> AGCTGAATTGTGTTGGGTAGTAAT
AGGTGGAGCGTCTAAAACGACCTA -> GGTGGAGCGTCTAAAACGACCTAG
GCAATCCGGCTCATCCAGCTCTAT -> CAATCCGGCTCATCCAGCTCTATG
TATGAAGCTCTTGACGTTTCACCA -> ATGAAGCTCTTGACGTTTCACCAC
CACTAGGGCTGACGCTCGTCTATT -> ACTAGGGCTGACGCTCGTCTATTT
TTCCATAGCGAGCCTATATTAGGC -> TCCATAGCGAGCCTATATTAGGCG
GCATCTTATACCAACAGTGTACCA -> CATCTTATACCAACAGTGTACCAA
GGAAACTCACAGCTAACATGAACG -> GAAACTCACAGCTAACATGAACGC
CGCCTTGATAATGCGACTTACCAA -> GCCTTGATAATGCGACTTACCAAG
AGTTCGGTAAGCAATTGCCATGCC -> GTTCGGTAAGCAATTGCCATGCCT
AAGCCCCAGCGCCGAGGTGCCTCA -> AGCCCCAGCGCCGAGGTGCCTCAC
AAAGCAATCCGGCTCATCCAGCTC -> AAGCAATCCGGCTCATCCAGCTCT
AGGCGCGTGTCCAAAAGGTGTTCA -> GGCGCGTGTCCAAAAGGTGTTCAG
CTTTGCATCTTATACCAACAGTGT -> TTTGCATCTTATACCAACAGTGTA
CCCTGATTGAAGACGTGGTCCGGG -> CCTGATTGAAGACGTGGTCCGGGC
GGATGGTCGAAGTCCAGTCCCGCG -> GATGGTCGAAGTCCAGTCCCGCGA
ATTAGGAAACTCACAGCTAACATG -> TTAGGAAACTCACAGCTAACATGA
TACGTCAATTATGAAGCTCTTGAC -> ACGTCAATTATGAAGCTCTTGACG
TTTACAGTGATTATAGGCAGGTTA -> TTACAGTGATTATAGGCAGGTTAG
AATTGTGTTGGGTAGTAATATGTT -> ATTGTGTTGGGTAGTAATATGTTC
GCAGCCAAGCTCGAGAATCTCCGG -> CAGCCAAGCTCGAGAATCTCCGGG
AGCTCTATGTATAGCAATTTCATG -> GCTCTATGTATAGCAATTTCATGT
ACACTAGGGCTGACGCTCGTCTAT -> CACTAGGGCTGACGCTCGTCTATT
ACCCTAGTAGGCTCTTCCGTTCCG -> CCCTAGTAGGCTCTTCCGTTCCGA
AGCTTACAATGCAGCCAAGCTCGA -> GCTTACAATGCAGCCAAGCTCGAG
TCCGCCGATCGGGATCCACGCCGT -> CCGCCGATCGGGATCCACGCCGTG
AAAGGTGTTCAGCGATTCCATCGG -> AAGGTGTTCAGCGATTCCATCGGA
ATCAACACTGATTCCTGGTCTCGG -> TCAACACTGATTCCTGGTCTCGGC
ACGAGCTGCTCCGATCAATAACTG -> CGAGCTGCTCCGATCAATAACTGA
AACTCACAGCTAACATGAACGCGA -> ACTCACAGCTAACATGAACGCGAC
TTAGTACCGAGTTCGGTAAGCAAT -> TAGTACCGAGTTCGGTAAGCAATT
TCATCCAGCTCTATGTATAGCAAT -> CATCCAGCTCTATGTATAGCAATT
CGCCGATCGGGATCCACGCCGTGT -> GCCGATCGGGATCCACGCCGTGTA
CTACAAACGGGGTTTAGTTTACAG -> TACAAACGGGGTTTAGTTTACAGT
TTACAGGTGGAGCGTCTAAAACGA -> TACAGGTGGAGCGTCTAAAACGAC
CGTGGTCCGGGCTGGAAGTGTCGG -> GTGGTCCGGGCTGGAAGTGTCGGC
CCTAGATTCCATAGCGAGCCTATA -> CTAGATTCCATAGCGAGCCTATAT
GAATTGTGTTGGGTAGTAATATGT -> AATTGTGTTGGGTAGTAATATGTT
TTTCCGCGGTACGACTTGTGAATG -> TTCCGCGGTACGACTTGTGAATGC
TCTATTTTACGGATTCTCTACAAA -> CTATTTTACGGATTCTCTACAAAC
CAATGGACCAGTGCTAGTTCAGAA -> AATGGACCAGTGCTAGTTCAGAAT
GGTTGTAGGGGTGCATAGACGGCT -> GTTGTAGGGGTGCATAGACGGCTG
CCGGCTCATCCAGCTCTATGTATA -> CGGCTCATCCAGCTCTATGTATAG
TATGTCGTTTGCTAAACTACCTTA -> ATGTCGTTTGCTAAACTACCTTAA
GCGCGTGTCCAAAAGGTGTTCAGC -> CGCGTGTCCAAAAGGTGTTCAGCG
CTGCTCCGATCAATAACTGATCTC -> TGCTCCGATCAATAACTGATCTCT
GCAGGTTAGTGCGCATTACAGGTG -> CAGGTTAGTGCGCATTACAGGTGG
CTTACCAAGGCGCGTGTCCAAAAG -> TTACCAAGGCGCGTGTCCAAAAGG
GGTCATTACTAGAATACGTCAATT -> GTCATTACTAGAATACGTCAATTA
GACGGTGCGGCTCTGGCCTTAATG -> ACGGTGCGGCTCTGGCCTTAATGC
AAATCCGCCTGACTTTCTATAGTT -> AATCCGCCTGACTTTCTATAGTTA
ACCATGCTCCTTGCGAGCGGCCAA -> CCATGCTCCTTGCGAGCGGCCAAC
TCGTGCAAAGCTTACAATGCAGCC -> CGTGCAAAGCTTACAATGCAGCCA
TACGGATGGTCGAAGTCCAGTCCC -> ACGGATGGTCGAAGTCCAGTCCCG
CTAGTAGGCTCTTCCGTTCCGATA -> TAGTAGGCTCTTCCGTTCCGATAT
CGGGATATAAACACTGGAGAACCA -> GGGATATAAACACTGGAGAACCAA
TGGTTGTTAGAGCATTCCCCAACC -> GGTTGTTAGAGCATTCCCCAACCT
CTAGATTCCATAGCGAGCCTATAT -> TAGATTCCATAGCGAGCCTATATT
CAATAACTGATCTCTGTACACATG -> AATAACTGATCTCTGTACACATGC
ACAATGGACCAGTGCTAGTTCAGA -> CAATGGACCAGTGCTAGTTCAGAA
CGCGATGGCCGGACATAGAGGGGA -> GCGATGGCCGGACATAGAGGGGAA
CGATATGGAACAAACTGGTCAGTT -> GATATGGAACAAACTGGTCAGTTC
GAATTAAGTAATGAATCAACACTG -> AATTAAGTAATGAATCAACACTGA
GTCGCGGATCCACAGGCCCTGATT -> TCGCGGATCCACAGGCCCTGATTG
GGTCAATGGCTCTGAGCTTATCCG -> GTCAATGGCTCTGAGCTTATCCGC
GCGGGATATAAACACTGGAGAACC -> CGGGATATAAACACTGGAGAACCA
GGTACACCGGTAAAAGATGAATAG -> GTACACCGGTAAAAGATGAATAGC
CTCCGCTGAGCGCGTAGGAGCTTT -> TCCGCTGAGCGCGTAGGAGCTTTT
ATCCACAGGCCCTGATTGAAGACG -> TCCACAGGCCCTGATTGAAGACGT
TGTCGTTTGCTAAACTACCTTAAT -> GTCGTTTGCTAAACTACCTTAATA
GGTCCGGCTGTACTCTGGCGGGGC -> GTCCGGCTGTACTCTGGCGGGGCC
TCGGACGGTGCGGCTCTGGCCTTA -> CGGACGGTGCGGCTCTGGCCTTAA
AGCTAACATGAACGCGACGCTATA -> GCTAACATGAACGCGACGCTATAC
GGCGCTCGGTCATTACTAGAATAC -> GCGCTCGGTCATTACTAGAATACG
TCGTCGTATGAGTAGTGTTCGTGC -> CGTCGTATGAGTAGTGTTCGTGCA
CCGAGGTGCCTCACTTAACGGGGA -> CGAGGTGCCTCACTTAACGGGGAA
AGCAATTGCCATGCCTCGTGCAAA -> GCAATTGCCATGCCTCGTGCAAAG
ACAGTGATTATAGGCAGGTTAGTG -> CAGTGATTATAGGCAGGTTAGTGC
GGAGCTTTGCATCTTATACCAACA -> GAGCTTTGCATCTTATACCAACAG
CAGGAATCTCGGATCCCTAGATTC -> AGGAATCTCGGATCCCTAGATTCC
GGCTGGAAGTGTCGGCCGTGATTA -> GCTGGAAGTGTCGGCCGTGATTAG
CGTCGTATGAGTAGTGTTCGTGCA -> GTCGTATGAGTAGTGTTCGTGCAG
ATTAGAAAAGGCGCTCGGTCATTA -> TTAGAAAAGGCGCTCGGTCATTAC
GGAGGAACGATGTTCATAATTTCT -> GAGGAACGATGTTCATAATTTCTT
TGGCCGGACATAGAGGGGAAGCTA -> GGCCGGACATAGAGGGGAAGCTAG
GACTTAAGGTTCTGCTGTCGGGGG -> ACTTAAGGTTCTGCTGTCGGGGGT
CACATGCGAAGCGGGAGCCAAGTC -> ACATGCGAAGCGGGAGCCAAGTCA
GATCGGGATCCACGCCGTGTATAT -> ATCGGGATCCACGCCGTGTATATA
TGGTAAGTTAAGTCCGAGGAGCTT -> GGTAAGTTAAGTCCGAGGAGCTTT
TAGTTTACAGTGATTATAGGCAGG -> AGTTTACAGTGATTATAGGCAGGT
CTGGCCTTCGCTAGTTTCCGCGGT -> TGGCCTTCGCTAGTTTCCGCGGTA
TGCAAAAGCCATTGGCCCTTGTGA -> GCAAAAGCCATTGGCCCTTGTGAA
TACATTGGTCCGGCTGTACTCTGG -> ACATTGGTCCGGCTGTACTCTGGC
ACACTTACGAGCTGCTCCGATCAA -> CACTTACGAGCTGCTCCGATCAAT
ACTTTCTATAGTTATTCCGTAGTC -> CTTTCTATAGTTATTCCGTAGTCT
CCCAACTTGACAGCAAGACTGGGA -> CCAACTTGACAGCAAGACTGGGAC
GGGGTTGTAGGGGTGCATAGACGG -> GGGTTGTAGGGGTGCATAGACGGC
GAGAATCTCCGGGCGCGATGGCCG -> AGAATCTCCGGGCGCGATGGCCGG
AACATTGTCTAATTGCCTCCAAAT -> ACATTGTCTAATTGCCTCCAAATT
ATCCGGCTCATCCAGCTCTATGTA -> TCCGGCTCATCCAGCTCTATGTAT
TCCGCCTGACTTTCTATAGTTATT -> CCGCCTGACTTTCTATAGTTATTC
TTCATAATTTCTTACGACTAGTTC -> TCATAATTTCTTACGACTAGTTCC
ATGGCCGGACATAGAGGGGAAGCT -> TGGCCGGACATAGAGGGGAAGCTA
GTCGAAGTCCAGTCCCGCGAGTTA -> TCGAAGTCCAGTCCCGCGAGTTAA
TATACTTGTATCGCGGGATATAAA -> ATACTTGTATCGCGGGATATAAAC
AAGTAATGAATCAACACTGATTCC -> AGTAATGAATCAACACTGATTCCT
TTTGACAGGCGCCTTGATAATGCG -> TTGACAGGCGCCTTGATAATGCGA
TGTAAAGTTTGACAGGCGCCTTGA -> GTAAAGTTTGACAGGCGCCTTGAT
ACACTGATTCCTGGTCTCGGCATT -> CACTGATTCCTGGTCTCGGCATTG
CGCGCCTAAAGTGGCCGTATTGGT -> GCGCCTAAAGTGGCCGTATTGGTA
GCGGCCGCCCTTACGGATGGTCGA -> CGGCCGCCCTTACGGATGGTCGAA
GGTCTTTTAATTGCGCACGTAAAA -> GTCTTTTAATTGCGCACGTAAAAT
ATGTCGTTTGCTAAACTACCTTAA -> TGTCGTTTGCTAAACTACCTTAAT
CATCAAGTAGAGCAAATACCCGCT -> ATCAAGTAGAGCAAATACCCGCTT
ATTAAGTAATGAATCAACACTGAT -> TTAAGTAATGAATCAACACTGATT
GGTATAAAGATCCCCCCTATACGA -> GTATAAAGATCCCCCCTATACGAG
CGGGGTTTAGTTTACAGTGATTAT -> GGGGTTTAGTTTACAGTGATTATA
ATAGAGTATCGATTTCCACCAGTT -> TAGAGTATCGATTTCCACCAGTTG
GTAGTGTTCGTGCAGGTGTTTAGG -> TAGTGTTCGTGCAGGTGTTTAGGT
CAGGTTAGTGCGCATTACAGGTGG -> AGGTTAGTGCGCATTACAGGTGGA
TAGTGATGGTTGTTAGAGCATTCC -> AGTGATGGTTGTTAGAGCATTCCC
AGTGATTATAGGCAGGTTAGTGCG -> GTGATTATAGGCAGGTTAGTGCGC
ATGAATCAACACTGATTCCTGGTC -> TGAATCAACACTGATTCCTGGTCT
AGGACAGGAATCTCGGATCCCTAG -> GGACAGGAATCTCGGATCCCTAGA
ATTATGAAGCTCTTGACGTTTCAC -> TTATGAAGCTCTTGACGTTTCACC
GATACAACGCCCCTCACGTGGTCT -> ATACAACGCCCCTCACGTGGTCTT
CCCAATGCGGCCGCCCTTACGGAT -> CCAATGCGGCCGCCCTTACGGATG
CGGCCGCCCTTACGGATGGTCGAA -> GGCCGCCCTTACGGATGGTCGAAG
TCATTAGGAAACTCACAGCTAACA -> CATTAGGAAACTCACAGCTAACAT
ACATGCGAAGCGGGAGCCAAGTCA -> CATGCGAAGCGGGAGCCAAGTCAT
CGGTAAAGCAATCCGGCTCATCCA -> GGTAAAGCAATCCGGCTCATCCAG
TCTCTCCGCTGAGCGCGTAGGAGC -> CTCTCCGCTGAGCGCGTAGGAGCT
GCATACTGCTGGCGAACCCTAGTA -> CATACTGCTGGCGAACCCTAGTAG
AGGCATACTGCTGGCGAACCCTAG -> GGCATACTGCTGGCGAACCCTAGT
TATACTTGATACAACGCCCCTCAC -> ATACTTGATACAACGCCCCTCACG
TTAATGCATGGCTCGCACGACACT -> TAATGCATGGCTCGCACGACACTT
GTAAGCAATTGCCATGCCTCGTGC -> TAAGCAATTGCCATGCCTCGTGCA
CTGCTGGCGAACCCTAGTAGGCTC -> TGCTGGCGAACCCTAGTAGGCTCT
GTTCCGATATGGAACAAACTGGTC -> TTCCGATATGGAACAAACTGGTCA
CAGTGGAACTATTTTACGCATGCG -> AGTGGAACTATTTTACGCATGCGA
GTGGCCGTATTGGTATAAAGATCC -> TGGCCGTATTGGTATAAAGATCCC
AAACTGGTCAGTTCTACACAAAAC -> AACTGGTCAGTTCTACACAAAACC
ACTAGGGCGAAATCGTCTCTTTTC -> CTAGGGCGAAATCGTCTCTTTTCG
AGGCGCTCGGTCATTACTAGAATA -> GGCGCTCGGTCATTACTAGAATAC
TCCAAAAGGTGTTCAGCGATTCCA -> CCAAAAGGTGTTCAGCGATTCCAT
TTGCATCTTATACCAACAGTGTAC -> TGCATCTTATACCAACAGTGTACC
TACTTGTATCGCGGGATATAAACA -> ACTTGTATCGCGGGATATAAACAC
TTTCCACCAGTTGCGAGGACAGGA -> TTCCACCAGTTGCGAGGACAGGAA
GGGAAGCTAGTGATGGTTGTTAGA -> GGAAGCTAGTGATGGTTGTTAGAG
CGACCTAATACTTAACCTTCTCTC -> GACCTAATACTTAACCTTCTCTCC
GGTAAGCAATTGCCATGCCTCGTG -> GTAAGCAATTGCCATGCCTCGTGC
CGTGAACATTGTCTAATTGCCTCC -> GTGAACATTGTCTAATTGCCTCCA
GTAAACTCGTTGCACAACTACACT -> TAAACTCGTTGCACAACTACACTA
TCATGTTATCCACTTGCCCAACGG -> CATGTTATCCACTTGCCCAACGGC
AGTACCGAGTTCGGTAAGCAATTG -> GTACCGAGTTCGGTAAGCAATTGC
GTATGGCTTGAGTTGAGTAGGCCC -> TATGGCTTGAGTTGAGTAGGCCCA
TACGCATGCGAGACATTAGCTGAA -> ACGCATGCGAGACATTAGCTGAAT
AATACTTAACCTTCTCTCCGCTGA -> ATACTTAACCTTCTCTCCGCTGAG
CCGGTAAGTACTTGACGTTTCCGT -> CGGTAAGTACTTGACGTTTCCGTA
CGCGTGTCCAAAAGGTGTTCAGCG -> GCGTGTCCAAAAGGTGTTCAGCGA
ATCCTTTAAAGGATCAAGCCCCAG -> TCCTTTAAAGGATCAAGCCCCAGC
GCGGTACGACTTGTGAATGCAAAA -> CGGTACGACTTGTGAATGCAAAAG
CGAGGAGCTTTGCATCTTATACCA -> GAGGAGCTTTGCATCTTATACCAA
GGGCGAAATCGTCTCTTTTCGTCG -> GGCGAAATCGTCTCTTTTCGTCGT
ATTGCCTCCAAATTTACATTGGTC -> TTGCCTCCAAATTTACATTGGTCC
TAGGCTCTTCCGTTCCGATATGGA -> AGGCTCTTCCGTTCCGATATGGAA
ACAATGCAGCCAAGCTCGAGAATC -> CAATGCAGCCAAGCTCGAGAATCT
GGCATACTGCTGGCGAACCCTAGT -> GCATACTGCTGGCGAACCCTAGTA
CTTTATGCAGCACGTCCGGTAAGT -> TTTATGCAGCACGTCCGGTAAGTA
CATAAATCCGCCTGACTTTCTATA -> ATAAATCCGCCTGACTTTCTATAG
TGGAAGTGTCGGCCGTGATTAGAA -> GGAAGTGTCGGCCGTGATTAGAAA
ACGGTGCGGCTCTGGCCTTAATGC -> CGGTGCGGCTCTGGCCTTAATGCA
ACGGGGAATGCAGGAGGAACGATG -> CGGGGAATGCAGGAGGAACGATGT
GCCCAACGGCTTACCTAGGAGTCC -> CCCAACGGCTTACCTAGGAGTCCC
GCGCGTAGGAGCTTTTAGTACCGA -> CGCGTAGGAGCTTTTAGTACCGAG
CACGTGGGTCAATGGCTCTGAGCT -> ACGTGGGTCAATGGCTCTGAGCTT
CATAGCGAGCCTATATTAGGCGCT -> ATAGCGAGCCTATATTAGGCGCTC
ACCGCGCCTAAAGTGGCCGTATTG -> CCGCGCCTAAAGTGGCCGTATTGG
ATTCTTGCAGTGGAACTATTTTAC -> TTCTTGCAGTGGAACTATTTTACG
ACCTATCCTTTAAAGGATCAAGCC -> CCTATCCTTTAAAGGATCAAGCCC
TCGATTTCCACCAGTTGCGAGGAC -> CGATTTCCACCAGTTGCGAGGACA
CTGTACTCTGGCGGGGCCACACAA -> TGTACTCTGGCGGGGCCACACAAT
TACCAAAGGCATACTGCTGGCGAA -> ACCAAAGGCATACTGCTGGCGAAC
TATTGGTATAAAGATCCCCCCTAT -> ATTGGTATAAAGATCCCCCCTATA
GGGATCCACGCCGTGTATATAAAG -> GGATCCACGCCGTGTATATAAAGA
CCTATCCTTTAAAGGATCAAGCCC -> CTATCCTTTAAAGGATCAAGCCCC
TCACCGCGCCTAAAGTGGCCGTAT -> CACCGCGCCTAAAGTGGCCGTATT
GGGGCCACACAATGGACCAGTGCT -> GGGCCACACAATGGACCAGTGCTA
AGGGGAAGCTAGTGATGGTTGTTA -> GGGGAAGCTAGTGATGGTTGTTAG
ACCTTAATATAAGATCGAGGCTTA -> CCTTAATATAAGATCGAGGCTTAG
CTTACAATGCAGCCAAGCTCGAGA -> TTACAATGCAGCCAAGCTCGAGAA
CGATGGCCGGACATAGAGGGGAAG -> GATGGCCGGACATAGAGGGGAAGC
ACGTGAACATTGTCTAATTGCCTC -> CGTGAACATTGTCTAATTGCCTCC
TGATTATAGGCAGGTTAGTGCGCA -> GATTATAGGCAGGTTAGTGCGCAT
GTTCATAATTTCTTACGACTAGTT -> TTCATAATTTCTTACGACTAGTTC
GACTAGTTCCTCCCAACTTGACAG -> ACTAGTTCCTCCCAACTTGACAGC
CACGACCTAATACTTAACCTTCTC -> ACGACCTAATACTTAACCTTCTCT
CCACGCCGTGTATATAAAGATATG -> CACGCCGTGTATATAAAGATATGT
ATGCTCCTTGCGAGCGGCCAACCT -> TGCTCCTTGCGAGCGGCCAACCTA
CTAGAATACGTCAATTATGAAGCT -> TAGAATACGTCAATTATGAAGCTC
TTACGAGCTGCTCCGATCAATAAC -> TACGAGCTGCTCCGATCAATAACT
GGGACCTTATACTTGTATCGCGGG -> GGACCTTATACTTGTATCGCGGGA
AGAATCTCCGGGCGCGATGGCCGG -> GAATCTCCGGGCGCGATGGCCGGA
AGTGTACCAAAGGCATACTGCTGG -> GTGTACCAAAGGCATACTGCTGGC
TTTCGTCGTATGAGTAGTGTTCGT -> TTCGTCGTATGAGTAGTGTTCGTG
TTAACGGGGAATGCAGGAGGAACG -> TAACGGGGAATGCAGGAGGAACGA
GTCTAATTGCCTCCAAATTTACAT -> TCTAATTGCCTCCAAATTTACATT
CGCGGATCCACAGGCCCTGATTGA -> GCGGATCCACAGGCCCTGATTGAA
GTATTGGTATAAAGATCCCCCCTA -> TATTGGTATAAAGATCCCCCCTAT
ATTGTCTAATTGCCTCCAAATTTA -> TTGTCTAATTGCCTCCAAATTTAC
TCAAGCATAGAGTATCGATTTCCA -> CAAGCATAGAGTATCGATTTCCAC
CTCGAGAATCTCCGGGCGCGATGG -> TCGAGAATCTCCGGGCGCGATGGC
ACACCGGTAAAAGATGAATAGCCA -> CACCGGTAAAAGATGAATAGCCAA
AGGCCCTGATTGAAGACGTGGTCC -> GGCCCTGATTGAAGACGTGGTCCG
TAAAATAGCCGTCGCGGATCCACA -> AAAATAGCCGTCGCGGATCCACAG
ATGAACGCGACGCTATACTTGATA -> TGAACGCGACGCTATACTTGATAC
TGTACCAAAGGCATACTGCTGGCG -> GTACCAAAGGCATACTGCTGGCGA
TTTGCTGGCCTTCGCTAGTTTCCG -> TTGCTGGCCTTCGCTAGTTTCCGC
GGAACTCCGGTAAAGCAATCCGGC -> GAACTCCGGTAAAGCAATCCGGCT
GACAGGCGCCTTGATAATGCGACT -> ACAGGCGCCTTGATAATGCGACTT
GTTTCACCACACGTCCCCGACTTA -> TTTCACCACACGTCCCCGACTTAA
TGCGCACGTAAAATTTCCGAGCTT -> GCGCACGTAAAATTTCCGAGCTTT
AAGGATCTCACGTGAACATTGTCT -> AGGATCTCACGTGAACATTGTCTA
GAGAATTAAGTAATGAATCAACAC -> AGAATTAAGTAATGAATCAACACT
GACTTTCTATAGTTATTCCGTAGT -> ACTTTCTATAGTTATTCCGTAGTC
GCGAACCCTAGTAGGCTCTTCCGT -> CGAACCCTAGTAGGCTCTTCCGTT
AGCGATTCCATCGGACGGTGCGGC -> GCGATTCCATCGGACGGTGCGGCT
TATCCGCCGATCGGGATCCACGCC -> ATCCGCCGATCGGGATCCACGCCG
TTTTACGGATTCTCTACAAACGGG -> TTTACGGATTCTCTACAAACGGGG
TCGGGATCCACGCCGTGTATATAA -> CGGGATCCACGCCGTGTATATAAA
CTCTTTTCGTCGTATGAGTAGTGT -> TCTTTTCGTCGTATGAGTAGTGTT
CATTACTAGAATACGTCAATTATG -> ATTACTAGAATACGTCAATTATGA
TAATATAAGATCGAGGCTTAGTCC -> AATATAAGATCGAGGCTTAGTCCA
GCTCGCACGACACTTACGAGCTGC -> CTCGCACGACACTTACGAGCTGCT
GGAGAACCAAGCGGAGAATTAAGT -> GAGAACCAAGCGGAGAATTAAGTA
AAGTTAAGTCCGAGGAGCTTTGCA -> AGTTAAGTCCGAGGAGCTTTGCAT
TAAGTCCGAGGAGCTTTGCATCTT -> AAGTCCGAGGAGCTTTGCATCTTA
AGTTTACAGTGATTATAGGCAGGT -> GTTTACAGTGATTATAGGCAGGTT
CGACTAGTTCCTCCCAACTTGACA -> GACTAGTTCCTCCCAACTTGACAG
ATGGTAAGTTAAGTCCGAGGAGCT -> TGGTAAGTTAAGTCCGAGGAGCTT
CGAAGGATCTCACGTGAACATTGT -> GAAGGATCTCACGTGAACATTGTC
AAGTAGAGCAAATACCCGCTTTTC -> AGTAGAGCAAATACCCGCTTTTCA
CACAAAACCTACGTATGGCTTGAG -> ACAAAACCTACGTATGGCTTGAGT
TCGGTAAGCAATTGCCATGCCTCG -> CGGTAAGCAATTGCCATGCCTCGT
TATAAAGATATGTCGTTTGCTAAA -> ATAAAGATATGTCGTTTGCTAAAC
CTGAATTGTGTTGGGTAGTAATAT -> TGAATTGTGTTGGGTAGTAATATG
TGCGGCTCTGGCCTTAATGCATGG -> GCGGCTCTGGCCTTAATGCATGGC
GAGACGCTCAGCGATGGTAAGTTA -> AGACGCTCAGCGATGGTAAGTTAA
ACTGGAGAACCAAGCGGAGAATTA -> CTGGAGAACCAAGCGGAGAATTAA
TACCGAGTTCGGTAAGCAATTGCC -> ACCGAGTTCGGTAAGCAATTGCCA
TCCTCCCAACTTGACAGCAAGACT -> CCTCCCAACTTGACAGCAAGACTG
CTTGTATCGCGGGATATAAACACT -> TTGTATCGCGGGATATAAACACTG
TGGAGCGTCTAAAACGACCTAGAG -> GGAGCGTCTAAAACGACCTAGAGG
CCCAGCGCCGAGGTGCCTCACTTA -> CCAGCGCCGAGGTGCCTCACTTAA
CAAGCGGAGAATTAAGTAATGAAT -> AAGCGGAGAATTAAGTAATGAATC
ACAGGAATCTCGGATCCCTAGATT -> CAGGAATCTCGGATCCCTAGATTC
TTCTTGCAGTGGAACTATTTTACG -> TCTTGCAGTGGAACTATTTTACGC
ATAAAGATATGTCGTTTGCTAAAC -> TAAAGATATGTCGTTTGCTAAACT
CAATTTCATGTTATCCACTTGCCC -> AATTTCATGTTATCCACTTGCCCA
GCGGAGAATTAAGTAATGAATCAA -> CGGAGAATTAAGTAATGAATCAAC
GAATGCAAAAGCCATTGGCCCTTG -> AATGCAAAAGCCATTGGCCCTTGT
CGCGAGTTAATTTTGGGCATCAAG -> GCGAGTTAATTTTGGGCATCAAGT
ATCGAGGCTTAGTCCACGACCTAA -> TCGAGGCTTAGTCCACGACCTAAT
CCGCGAGTTAATTTTGGGCATCAA -> CGCGAGTTAATTTTGGGCATCAAG
GGGTGCATAGACGGCTGTGTAAAG -> GGTGCATAGACGGCTGTGTAAAGT
CATGCGAAGCGGGAGCCAAGTCAT -> ATGCGAAGCGGGAGCCAAGTCATA
AAAAGGCGCTCGGTCATTACTAGA -> AAAGGCGCTCGGTCATTACTAGAA
AGTGGAACTATTTTACGCATGCGA -> GTGGAACTATTTTACGCATGCGAG
CTGGCCTTAATGCATGGCTCGCAC -> TGGCCTTAATGCATGGCTCGCACG
CCACACGTCCCCGACTTAAGGTTC -> CACACGTCCCCGACTTAAGGTTCT
AACGGCTTACCTAGGAGTCCCACG -> ACGGCTTACCTAGGAGTCCCACGT
AGCCAAGTCATAAATCCGCCTGAC -> GCCAAGTCATAAATCCGCCTGACT
AGCTCTTGACGTTTCACCACACGT -> GCTCTTGACGTTTCACCACACGTC
TGCATAGACGGCTGTGTAAAGTTT -> GCATAGACGGCTGTGTAAAGTTTG
AACTACCTTAATATAAGATCGAGG -> ACTACCTTAATATAAGATCGAGGC
CGTTTCCGTACTCACCGCGCCTAA -> GTTTCCGTACTCACCGCGCCTAAA
CTTAATATAAGATCGAGGCTTAGT -> TTAATATAAGATCGAGGCTTAGTC
GGCCGTGATTAGAAAAGGCGCTCG -> GCCGTGATTAGAAAAGGCGCTCGG
TGCAGGTGTTTAGGTACACCGGTA -> GCAGGTGTTTAGGTACACCGGTAA
CTTGAGTTGAGTAGGCCCAATGCG -> TTGAGTTGAGTAGGCCCAATGCGG
TCGGTCATTACTAGAATACGTCAA -> CGGTCATTACTAGAATACGTCAAT
ATACTGCTGGCGAACCCTAGTAGG -> TACTGCTGGCGAACCCTAGTAGGC
ACATGAACGCGACGCTATACTTGA -> CATGAACGCGACGCTATACTTGAT
AGAATTAAGTAATGAATCAACACT -> GAATTAAGTAATGAATCAACACTG
GTATCGCGGGATATAAACACTGGA -> TATCGCGGGATATAAACACTGGAG
CCGCCGATCGGGATCCACGCCGTG -> CGCCGATCGGGATCCACGCCGTGT
GTACACATGCGAAGCGGGAGCCAA -> TACACATGCGAAGCGGGAGCCAAG
GCTTTTAGTACCGAGTTCGGTAAG -> CTTTTAGTACCGAGTTCGGTAAGC
GCCATGCCTCGTGCAAAGCTTACA -> CCATGCCTCGTGCAAAGCTTACAA
CATTGTGCCACCATGCTCCTTGCG -> ATTGTGCCACCATGCTCCTTGCGA
TGAATAGCCAAGGATGCGAAGGAT -> GAATAGCCAAGGATGCGAAGGATC
GGCCTTAATGCATGGCTCGCACGA -> GCCTTAATGCATGGCTCGCACGAC
TGCCTCGTGCAAAGCTTACAATGC -> GCCTCGTGCAAAGCTTACAATGCA
CTACGTATGGCTTGAGTTGAGTAG -> TACGTATGGCTTGAGTTGAGTAGG
ACTTGACGTTTCCGTACTCACCGC -> CTTGACGTTTCCGTACTCACCGCG
CAACGCCCCTCACGTGGTCTTTTA -> AACGCCCCTCACGTGGTCTTTTAA
TTTCATTAGGAAACTCACAGCTAA -> TTCATTAGGAAACTCACAGCTAAC
TCCAGTCCCGCGAGTTAATTTTGG -> CCAGTCCCGCGAGTTAATTTTGGG
ACTCACCGCGCCTAAAGTGGCCGT -> CTCACCGCGCCTAAAGTGGCCGTA
TTGGGTAGTAATATGTTCGTAAAA -> TGGGTAGTAATATGTTCGTAAAAT
GCATAGAGTATCGATTTCCACCAG -> CATAGAGTATCGATTTCCACCAGT
AGTTCCTCCCAACTTGACAGCAAG -> GTTCCTCCCAACTTGACAGCAAGA
AATTTCCGAGCTTTGCTGGCCTTC -> ATTTCCGAGCTTTGCTGGCCTTCG
TGGAACAAACTGGTCAGTTCTACA -> GGAACAAACTGGTCAGTTCTACAC
AGGAGTCCCACGTGGGTCAATGGC -> GGAGTCCCACGTGGGTCAATGGCT
GAATAGCCAAGGATGCGAAGGATC -> AATAGCCAAGGATGCGAAGGATCT
ACGAGACGCTCAGCGATGGTAAGT -> CGAGACGCTCAGCGATGGTAAGTT
TTATAGGCAGGTTAGTGCGCATTA -> TATAGGCAGGTTAGTGCGCATTAC
TTTACGCATGCGAGACATTAGCTG -> TTACGCATGCGAGACATTAGCTGA
CGTAAAATAGCCGTCGCGGATCCA -> GTAAAATAGCCGTCGCGGATCCAC
TCGAGGCTTAGTCCACGACCTAAT -> CGAGGCTTAGTCCACGACCTAATA
CCCCCTATACGAGACGCTCAGCGA -> CCCCTATACGAGACGCTCAGCGAT
AACTGGTCAGTTCTACACAAAACC -> ACTGGTCAGTTCTACACAAAACCT
ACGTGGGTCAATGGCTCTGAGCTT -> CGTGGGTCAATGGCTCTGAGCTTA
TCTCTGTACACATGCGAAGCGGGA -> CTCTGTACACATGCGAAGCGGGAG
TCCGGGCGCGATGGCCGGACATAG -> CCGGGCGCGATGGCCGGACATAGA
GGTGTTTAGGTACACCGGTAAAAG -> GTGTTTAGGTACACCGGTAAAAGA
GGGGAATGCAGGAGGAACGATGTT -> GGGAATGCAGGAGGAACGATGTTC
CTTACCTAGGAGTCCCACGTGGGT -> TTACCTAGGAGTCCCACGTGGGTC
TCTAATTGCCTCCAAATTTACATT -> CTAATTGCCTCCAAATTTACATTG
ACAAACGGGGTTTAGTTTACAGTG -> CAAACGGGGTTTAGTTTACAGTGA
ATCCCCCCTATACGAGACGCTCAG -> TCCCCCCTATACGAGACGCTCAGC
GACATAGAGGGGAAGCTAGTGATG -> ACATAGAGGGGAAGCTAGTGATGG
AGAACCAAGCGGAGAATTAAGTAA -> GAACCAAGCGGAGAATTAAGTAAT
TCCGGTAAAGCAATCCGGCTCATC -> CCGGTAAAGCAATCCGGCTCATCC
ATGGTTGTTAGAGCATTCCCCAAC -> TGGTTGTTAGAGCATTCCCCAACC
CAGTTGCGAGGACAGGAATCTCGG -> AGTTGCGAGGACAGGAATCTCGGA
CCTTCGCTAGTTTCCGCGGTACGA -> CTTCGCTAGTTTCCGCGGTACGAC
CGAGTTAATTTTGGGCATCAAGTA -> GAGTTAATTTTGGGCATCAAGTAG
GCGGCCAACCTATCCTTTAAAGGA -> CGGCCAACCTATCCTTTAAAGGAT
ACGTCCCCGACTTAAGGTTCTGCT -> CGTCCCCGACTTAAGGTTCTGCTG
CAGCGATTCCATCGGACGGTGCGG -> AGCGATTCCATCGGACGGTGCGGC
CACTGATTCCTGGTCTCGGCATTG -> ACTGATTCCTGGTCTCGGCATTGT
GGGCGCGATGGCCGGACATAGAGG -> GGCGCGATGGCCGGACATAGAGGG
CACGTCCCCGACTTAAGGTTCTGC -> ACGTCCCCGACTTAAGGTTCTGCT
GTAAAAGATGAATAGCCAAGGATG -> TAAAAGATGAATAGCCAAGGATGC
GAGGAACGATGTTCATAATTTCTT -> AGGAACGATGTTCATAATTTCTTA
TGTCGGGGGTTGTAGGGGTGCATA -> GTCGGGGGTTGTAGGGGTGCATAG
AAATAGCCGTCGCGGATCCACAGG -> AATAGCCGTCGCGGATCCACAGGC
CCTTCTCTCCGCTGAGCGCGTAGG -> CTTCTCTCCGCTGAGCGCGTAGGA
AACTCCGGTAAAGCAATCCGGCTC -> ACTCCGGTAAAGCAATCCGGCTCA
CCACGACCTAATACTTAACCTTCT -> CACGACCTAATACTTAACCTTCTC
TGAGTAGTGTTCGTGCAGGTGTTT -> GAGTAGTGTTCGTGCAGGTGTTTA
ACCTAATACTTAACCTTCTCTCCG -> CCTAATACTTAACCTTCTCTCCGC
AGCTTTGCATCTTATACCAACAGT -> GCTTTGCATCTTATACCAACAGTG
TATGTTCGTAAAATAGCCGTCGCG -> ATGTTCGTAAAATAGCCGTCGCGG
TGTTCGTGCAGGTGTTTAGGTACA -> GTTCGTGCAGGTGTTTAGGTACAC
TTACAATGCAGCCAAGCTCGAGAA -> TACAATGCAGCCAAGCTCGAGAAT
GAAATCGTCTCTTTTCGTCGTATG -> AAATCGTCTCTTTTCGTCGTATGA
ATCGATTTCCACCAGTTGCGAGGA -> TCGATTTCCACCAGTTGCGAGGAC
GTAAGTTAAGTCCGAGGAGCTTTG -> TAAGTTAAGTCCGAGGAGCTTTGC
TATCCACTTGCCCAACGGCTTACC -> ATCCACTTGCCCAACGGCTTACCT
TCGCTAGTTTCCGCGGTACGACTT -> CGCTAGTTTCCGCGGTACGACTTG
GTGGTCCGGGCTGGAAGTGTCGGC -> TGGTCCGGGCTGGAAGTGTCGGCC
ATTTCCGAGCTTTGCTGGCCTTCG -> TTTCCGAGCTTTGCTGGCCTTCGC
AGGGGTGCATAGACGGCTGTGTAA -> GGGGTGCATAGACGGCTGTGTAAA
CGGTAAAAGATGAATAGCCAAGGA -> GGTAAAAGATGAATAGCCAAGGAT
AGGAGGAACGATGTTCATAATTTC -> GGAGGAACGATGTTCATAATTTCT
TACACAAAACCTACGTATGGCTTG -> ACACAAAACCTACGTATGGCTTGA
ACTCCGGTAAAGCAATCCGGCTCA -> CTCCGGTAAAGCAATCCGGCTCAT
TAGTGCGCATTACAGGTGGAGCGT -> AGTGCGCATTACAGGTGGAGCGTC
GACGTTTCCGTACTCACCGCGCCT -> ACGTTTCCGTACTCACCGCGCCTA
CGCATGCGAGACATTAGCTGAATT -> GCATGCGAGACATTAGCTGAATTG
ACGTCAATTATGAAGCTCTTGACG -> CGTCAATTATGAAGCTCTTGACGT
ATGCGGCCGCCCTTACGGATGGTC -> TGCGGCCGCCCTTACGGATGGTCG
GCGCATTACAGGTGGAGCGTCTAA -> CGCATTACAGGTGGAGCGTCTAAA
TCCACGCCGTGTATATAAAGATAT -> CCACGCCGTGTATATAAAGATATG
AGCATTCCCCAACCTCAAGCATAG -> GCATTCCCCAACCTCAAGCATAGA
AGACATTAGCTGAATTGTGTTGGG -> GACATTAGCTGAATTGTGTTGGGT
GTACCGAGTTCGGTAAGCAATTGC -> TACCGAGTTCGGTAAGCAATTGCC
TAAAGATCCCCCCTATACGAGACG -> AAAGATCCCCCCTATACGAGACGC
TTCCGATATGGAACAAACTGGTCA -> TCCGATATGGAACAAACTGGTCAG
CAGAATTCTTGCAGTGGAACTATT -> AGAATTCTTGCAGTGGAACTATTT
CAAGTCATAAATCCGCCTGACTTT -> AAGTCATAAATCCGCCTGACTTTC
TGTCCAAAAGGTGTTCAGCGATTC -> GTCCAAAAGGTGTTCAGCGATTCC
CTTGACGTTTCCGTACTCACCGCG -> TTGACGTTTCCGTACTCACCGCGC
CAGCGCCGAGGTGCCTCACTTAAC -> AGCGCCGAGGTGCCTCACTTAACG
CATTAGCTGAATTGTGTTGGGTAG -> ATTAGCTGAATTGTGTTGGGTAGT
TAGGGCGAAATCGTCTCTTTTCGT -> AGGGCGAAATCGTCTCTTTTCGTC
TGGAGAACCAAGCGGAGAATTAAG -> GGAGAACCAAGCGGAGAATTAAGT
GCGACGCTATACTTGATACAACGC -> CGACGCTATACTTGATACAACGCC
AATCCGGCTCATCCAGCTCTATGT -> ATCCGGCTCATCCAGCTCTATGTA
ATAAAGATCCCCCCTATACGAGAC -> TAAAGATCCCCCCTATACGAGACG
TACCTAGGAGTCCCACGTGGGTCA -> ACCTAGGAGTCCCACGTGGGTCAA
TACTCTGGCGGGGCCACACAATGG -> ACTCTGGCGGGGCCACACAATGGA
GCCAAGCTCGAGAATCTCCGGGCG -> CCAAGCTCGAGAATCTCCGGGCGC
GATCGAGGCTTAGTCCACGACCTA -> ATCGAGGCTTAGTCCACGACCTAA
CTGGCGGGGCCACACAATGGACCA -> TGGCGGGGCCACACAATGGACCAG
GTTCGGTAAGCAATTGCCATGCCT -> TTCGGTAAGCAATTGCCATGCCTC
GGACAGGAATCTCGGATCCCTAGA -> GACAGGAATCTCGGATCCCTAGAT
TTGCCCAACGGCTTACCTAGGAGT -> TGCCCAACGGCTTACCTAGGAGTC
CGCGTAGGAGCTTTTAGTACCGAG -> GCGTAGGAGCTTTTAGTACCGAGT
AACAAACTGGTCAGTTCTACACAA -> ACAAACTGGTCAGTTCTACACAAA
TACGGATTCTCTACAAACGGGGTT -> ACGGATTCTCTACAAACGGGGTTT
CTCCGATCAATAACTGATCTCTGT -> TCCGATCAATAACTGATCTCTGTA
CCAAGCGGAGAATTAAGTAATGAA -> CAAGCGGAGAATTAAGTAATGAAT
CGCTCAGCGATGGTAAGTTAAGTC -> GCTCAGCGATGGTAAGTTAAGTCC
TTCTCTACAAACGGGGTTTAGTTT -> TCTCTACAAACGGGGTTTAGTTTA
CAACCTCAAGCATAGAGTATCGAT -> AACCTCAAGCATAGAGTATCGATT
ATGGCTTGAGTTGAGTAGGCCCAA -> TGGCTTGAGTTGAGTAGGCCCAAT
CACAGGCCCTGATTGAAGACGTGG -> ACAGGCCCTGATTGAAGACGTGGT
GTAAAGTTTGACAGGCGCCTTGAT -> TAAAGTTTGACAGGCGCCTTGATA
TATCGCGGGATATAAACACTGGAG -> ATCGCGGGATATAAACACTGGAGA
TCGTTGCACAACTACACTAGGGCT -> CGTTGCACAACTACACTAGGGCTG
TAAGATCGAGGCTTAGTCCACGAC -> AAGATCGAGGCTTAGTCCACGACC
TTCTATAGTTATTCCGTAGTCTTT -> TCTATAGTTATTCCGTAGTCTTTA
ACTTAACCTTCTCTCCGCTGAGCG -> CTTAACCTTCTCTCCGCTGAGCGC
TCCTTTAAAGGATCAAGCCCCAGC -> CCTTTAAAGGATCAAGCCCCAGCG
TACGTATGGCTTGAGTTGAGTAGG -> ACGTATGGCTTGAGTTGAGTAGGC
GTTATTCCGTAGTCTTTATGCAGC -> TTATTCCGTAGTCTTTATGCAGCA
GGTACGACTTGTGAATGCAAAAGC -> GTACGACTTGTGAATGCAAAAGCC
GATGAATAGCCAAGGATGCGAAGG -> ATGAATAGCCAAGGATGCGAAGGA
TACTTAACCTTCTCTCCGCTGAGC -> ACTTAACCTTCTCTCCGCTGAGCG
TAGGGGTGCATAGACGGCTGTGTA -> AGGGGTGCATAGACGGCTGTGTAA
GTCGGCCGTGATTAGAAAAGGCGC -> TCGGCCGTGATTAGAAAAGGCGCT
TTTTCGTCGTATGAGTAGTGTTCG -> TTTCGTCGTATGAGTAGTGTTCGT
TAAAACGACCTAGAGGAACTCCGG -> AAAACGACCTAGAGGAACTCCGGT
CGACTTGTGAATGCAAAAGCCATT -> GACTTGTGAATGCAAAAGCCATTG
GTAAAATTTCCGAGCTTTGCTGGC -> TAAAATTTCCGAGCTTTGCTGGCC
TATTCCGTAGTCTTTATGCAGCAC -> ATTCCGTAGTCTTTATGCAGCACG
GGACGGTGCGGCTCTGGCCTTAAT -> GACGGTGCGGCTCTGGCCTTAATG
CTTACGACTAGTTCCTCCCAACTT -> TTACGACTAGTTCCTCCCAACTTG
CATCTTATACCAACAGTGTACCAA -> ATCTTATACCAACAGTGTACCAAA
GTACACCGGTAAAAGATGAATAGC -> TACACCGGTAAAAGATGAATAGCC
CGAACCCTAGTAGGCTCTTCCGTT -> GAACCCTAGTAGGCTCTTCCGTTC
GGTAGTAATATGTTCGTAAAATAG -> GTAGTAATATGTTCGTAAAATAGC
CCGCTTTTCATTAGGAAACTCACA -> CGCTTTTCATTAGGAAACTCACAG
AACAGTGTACCAAAGGCATACTGC -> ACAGTGTACCAAAGGCATACTGCT
CGACCTAGAGGAACTCCGGTAAAG -> GACCTAGAGGAACTCCGGTAAAGC
GGCCTTCGCTAGTTTCCGCGGTAC -> GCCTTCGCTAGTTTCCGCGGTACG
GTTCCTCCCAACTTGACAGCAAGA -> TTCCTCCCAACTTGACAGCAAGAC
TGCAGTGGAACTATTTTACGCATG -> GCAGTGGAACTATTTTACGCATGC
CCGCTGAGCGCGTAGGAGCTTTTA -> CGCTGAGCGCGTAGGAGCTTTTAG
TTTGCTAAACTACCTTAATATAAG -> TTGCTAAACTACCTTAATATAAGA
CCGGTAAAGCAATCCGGCTCATCC -> CGGTAAAGCAATCCGGCTCATCCA
AGAATACGTCAATTATGAAGCTCT -> GAATACGTCAATTATGAAGCTCTT
GTTTAGGTACACCGGTAAAAGATG -> TTTAGGTACACCGGTAAAAGATGA
GAGGAACTCCGGTAAAGCAATCCG -> AGGAACTCCGGTAAAGCAATCCGG
AACTTGACAGCAAGACTGGGACGA -> ACTTGACAGCAAGACTGGGACGAC
GTGTCGGCCGTGATTAGAAAAGGC -> TGTCGGCCGTGATTAGAAAAGGCG
GTGGAGCGTCTAAAACGACCTAGA -> TGGAGCGTCTAAAACGACCTAGAG
AGTTATTCCGTAGTCTTTATGCAG -> GTTATTCCGTAGTCTTTATGCAGC
ACTATTTTACGCATGCGAGACATT -> CTATTTTACGCATGCGAGACATTA
CAAAGGCATACTGCTGGCGAACCC -> AAAGGCATACTGCTGGCGAACCCT
TAACATGAACGCGACGCTATACTT -> AACATGAACGCGACGCTATACTTG
GCTGCTCCGATCAATAACTGATCT -> CTGCTCCGATCAATAACTGATCTC
AAGCTCGAGAATCTCCGGGCGCGA -> AGCTCGAGAATCTCCGGGCGCGAT
TACAACGCCCCTCACGTGGTCTTT -> ACAACGCCCCTCACGTGGTCTTTT
GTTTCCGCGGTACGACTTGTGAAT -> TTTCCGCGGTACGACTTGTGAATG
AGATCCCCCCTATACGAGACGCTC -> GATCCCCCCTATACGAGACGCTCA
GATATGTCGTTTGCTAAACTACCT -> ATATGTCGTTTGCTAAACTACCTT
AAAGCTTACAATGCAGCCAAGCTC -> AAGCTTACAATGCAGCCAAGCTCG
GTGCAGGTGTTTAGGTACACCGGT -> TGCAGGTGTTTAGGTACACCGGTA
AGGAACTCCGGTAAAGCAATCCGG -> GGAACTCCGGTAAAGCAATCCGGC
AGGCGCCTTGATAATGCGACTTAC -> GGCGCCTTGATAATGCGACTTACC
ACAACTACACTAGGGCTGACGCTC -> CAACTACACTAGGGCTGACGCTCG
TCAATTATGAAGCTCTTGACGTTT -> CAATTATGAAGCTCTTGACGTTTC
GTTGAGTAGGCCCAATGCGGCCGC -> TTGAGTAGGCCCAATGCGGCCGCC
CACACAATGGACCAGTGCTAGTTC -> ACACAATGGACCAGTGCTAGTTCA
TAGAAAAGGCGCTCGGTCATTACT -> AGAAAAGGCGCTCGGTCATTACTA
GTGCCTCACTTAACGGGGAATGCA -> TGCCTCACTTAACGGGGAATGCAG
GTTAATTTTGGGCATCAAGTAGAG -> TTAATTTTGGGCATCAAGTAGAGC
ACACATGCGAAGCGGGAGCCAAGT -> CACATGCGAAGCGGGAGCCAAGTC
CCAGTTGCGAGGACAGGAATCTCG -> CAGTTGCGAGGACAGGAATCTCGG
GTCTAAAACGACCTAGAGGAACTC -> TCTAAAACGACCTAGAGGAACTCC
CAATGGCTCTGAGCTTATCCGCCG -> AATGGCTCTGAGCTTATCCGCCGA
ACAAAACCTACGTATGGCTTGAGT -> CAAAACCTACGTATGGCTTGAGTT
TGGCCTTCGCTAGTTTCCGCGGTA -> GGCCTTCGCTAGTTTCCGCGGTAC
ATATGTTCGTAAAATAGCCGTCGC -> TATGTTCGTAAAATAGCCGTCGCG
TTATGCAGCACGTCCGGTAAGTAC -> TATGCAGCACGTCCGGTAAGTACT
CCAACCTCAAGCATAGAGTATCGA -> CAACCTCAAGCATAGAGTATCGAT
GGCAGGTTAGTGCGCATTACAGGT -> GCAGGTTAGTGCGCATTACAGGTG
TAAAGATATGTCGTTTGCTAAACT -> AAAGATATGTCGTTTGCTAAACTA
AATACCCGCTTTTCATTAGGAAAC -> ATACCCGCTTTTCATTAGGAAACT
GCATTCCCCAACCTCAAGCATAGA -> CATTCCCCAACCTCAAGCATAGAG
GGCTTGAGTTGAGTAGGCCCAATG -> GCTTGAGTTGAGTAGGCCCAATGC
CTTTTAATTGCGCACGTAAAATTT -> TTTTAATTGCGCACGTAAAATTTC
TCAGTTCTACACAAAACCTACGTA -> CAGTTCTACACAAAACCTACGTAT
ATCCGCCGATCGGGATCCACGCCG -> TCCGCCGATCGGGATCCACGCCGT
CCACTTGCCCAACGGCTTACCTAG -> CACTTGCCCAACGGCTTACCTAGG
CGAGACATTAGCTGAATTGTGTTG -> GAGACATTAGCTGAATTGTGTTGG
CTGACTTTCTATAGTTATTCCGTA -> TGACTTTCTATAGTTATTCCGTAG
TCTCCGCTGAGCGCGTAGGAGCTT -> CTCCGCTGAGCGCGTAGGAGCTTT
AAAAGATGAATAGCCAAGGATGCG -> AAAGATGAATAGCCAAGGATGCGA
GCGATGGTAAGTTAAGTCCGAGGA -> CGATGGTAAGTTAAGTCCGAGGAG
ATTACAGGTGGAGCGTCTAAAACG -> TTACAGGTGGAGCGTCTAAAACGA
TTCCTCCCAACTTGACAGCAAGAC -> TCCTCCCAACTTGACAGCAAGACT
AGGATCTCACGTGAACATTGTCTA -> GGATCTCACGTGAACATTGTCTAA
TTGAGTAGGCCCAATGCGGCCGCC -> TGAGTAGGCCCAATGCGGCCGCCC
GAGCCTATATTAGGCGCTCCTAAT -> AGCCTATATTAGGCGCTCCTAATG
TGCAGCACGTCCGGTAAGTACTTG -> GCAGCACGTCCGGTAAGTACTTGA
GGAACAAACTGGTCAGTTCTACAC -> GAACAAACTGGTCAGTTCTACACA
GTAGGCTCTTCCGTTCCGATATGG -> TAGGCTCTTCCGTTCCGATATGGA
CTAATACTTAACCTTCTCTCCGCT -> TAATACTTAACCTTCTCTCCGCTG
ATCGGGATCCACGCCGTGTATATA -> TCGGGATCCACGCCGTGTATATAA
ATATGTCGTTTGCTAAACTACCTT -> TATGTCGTTTGCTAAACTACCTTA
GCCCCAGCGCCGAGGTGCCTCACT -> CCCCAGCGCCGAGGTGCCTCACTT
GCATGGCTCGCACGACACTTACGA -> CATGGCTCGCACGACACTTACGAG
GATGGTCGAAGTCCAGTCCCGCGA -> ATGGTCGAAGTCCAGTCCCGCGAG
ACTAGTAAACTCGTTGCACAACTA -> CTAGTAAACTCGTTGCACAACTAC
AATCTCGGATCCCTAGATTCCATA -> ATCTCGGATCCCTAGATTCCATAG
ATTTCTTACGACTAGTTCCTCCCA -> TTTCTTACGACTAGTTCCTCCCAA
TTCGTGCAGGTGTTTAGGTACACC -> TCGTGCAGGTGTTTAGGTACACCG
TAAAGCAATCCGGCTCATCCAGCT -> AAAGCAATCCGGCTCATCCAGCTC
CCTACGTATGGCTTGAGTTGAGTA -> CTACGTATGGCTTGAGTTGAGTAG
GGCGAACCCTAGTAGGCTCTTCCG -> GCGAACCCTAGTAGGCTCTTCCGT
AGTTTCCGCGGTACGACTTGTGAA -> GTTTCCGCGGTACGACTTGTGAAT
GATCCCCCCTATACGAGACGCTCA -> ATCCCCCCTATACGAGACGCTCAG
ATTTACATTGGTCCGGCTGTACTC -> TTTACATTGGTCCGGCTGTACTCT
GTCATAAATCCGCCTGACTTTCTA -> TCATAAATCCGCCTGACTTTCTAT
CCATGCTCCTTGCGAGCGGCCAAC -> CATGCTCCTTGCGAGCGGCCAACC
AAGGATCAAGCCCCAGCGCCGAGG -> AGGATCAAGCCCCAGCGCCGAGGT
TGAATCAACACTGATTCCTGGTCT -> GAATCAACACTGATTCCTGGTCTC
TTATTCCGTAGTCTTTATGCAGCA -> TATTCCGTAGTCTTTATGCAGCAC
ATAGAGGGGAAGCTAGTGATGGTT -> TAGAGGGGAAGCTAGTGATGGTTG
GCAGTGGAACTATTTTACGCATGC -> CAGTGGAACTATTTTACGCATGCG
ACCTTCTCTCCGCTGAGCGCGTAG -> CCTTCTCTCCGCTGAGCGCGTAGG
AATTGCGCACGTAAAATTTCCGAG -> ATTGCGCACGTAAAATTTCCGAGC
TGTTGGGTAGTAATATGTTCGTAA -> GTTGGGTAGTAATATGTTCGTAAA
GCCGTGTATATAAAGATATGTCGT -> CCGTGTATATAAAGATATGTCGTT
CCGTGTATATAAAGATATGTCGTT -> CGTGTATATAAAGATATGTCGTTT
GGCTCTGAGCTTATCCGCCGATCG -> GCTCTGAGCTTATCCGCCGATCGG
CTCTTGACGTTTCACCACACGTCC -> TCTTGACGTTTCACCACACGTCCC
TCAACACTGATTCCTGGTCTCGGC -> CAACACTGATTCCTGGTCTCGGCA
AGCGATGGTAAGTTAAGTCCGAGG -> GCGATGGTAAGTTAAGTCCGAGGA
TTCGTAAAATAGCCGTCGCGGATC -> TCGTAAAATAGCCGTCGCGGATCC
TGACGTTTCACCACACGTCCCCGA -> GACGTTTCACCACACGTCCCCGAC
ACTTGTGAATGCAAAAGCCATTGG -> CTTGTGAATGCAAAAGCCATTGGC
CTCCCAACTTGACAGCAAGACTGG -> TCCCAACTTGACAGCAAGACTGGG
ACGGGGTTTAGTTTACAGTGATTA -> CGGGGTTTAGTTTACAGTGATTAT
AACTACACTAGGGCTGACGCTCGT -> ACTACACTAGGGCTGACGCTCGTC
AAAAGCCATTGGCCCTTGTGAATC -> AAAGCCATTGGCCCTTGTGAATCA
AGGTACACCGGTAAAAGATGAATA -> GGTACACCGGTAAAAGATGAATAG
TCAGCGATTCCATCGGACGGTGCG -> CAGCGATTCCATCGGACGGTGCGG
CGTGTATATAAAGATATGTCGTTT -> GTGTATATAAAGATATGTCGTTTG
TCTTTATGCAGCACGTCCGGTAAG -> CTTTATGCAGCACGTCCGGTAAGT
TTTATGCAGCACGTCCGGTAAGTA -> TTATGCAGCACGTCCGGTAAGTAC
AGTTGAGTAGGCCCAATGCGGCCG -> GTTGAGTAGGCCCAATGCGGCCGC
CCTGACTTTCTATAGTTATTCCGT -> CTGACTTTCTATAGTTATTCCGTA
GCCTCGTGCAAAGCTTACAATGCA -> CCTCGTGCAAAGCTTACAATGCAG
TCGGCCGTGATTAGAAAAGGCGCT -> CGGCCGTGATTAGAAAAGGCGCTC
CATGAACGCGACGCTATACTTGAT -> ATGAACGCGACGCTATACTTGATA
TAAGTACTTGACGTTTCCGTACTC -> AAGTACTTGACGTTTCCGTACTCA
AACATGAACGCGACGCTATACTTG -> ACATGAACGCGACGCTATACTTGA
GCAATTGCCATGCCTCGTGCAAAG -> CAATTGCCATGCCTCGTGCAAAGC
CGCCCCTCACGTGGTCTTTTAATT -> GCCCCTCACGTGGTCTTTTAATTG
ATTGGTCCGGCTGTACTCTGGCGG -> TTGGTCCGGCTGTACTCTGGCGGG
AGGTGCCTCACTTAACGGGGAATG -> GGTGCCTCACTTAACGGGGAATGC
GTACTTGACGTTTCCGTACTCACC -> TACTTGACGTTTCCGTACTCACCG
AGTAGTGTTCGTGCAGGTGTTTAG -> GTAGTGTTCGTGCAGGTGTTTAGG
TAACGGGGAATGCAGGAGGAACGA -> AACGGGGAATGCAGGAGGAACGAT
CAGCACGTCCGGTAAGTACTTGAC -> AGCACGTCCGGTAAGTACTTGACG
TTGCTAAACTACCTTAATATAAGA -> TGCTAAACTACCTTAATATAAGAT
GTCCCACGTGGGTCAATGGCTCTG -> TCCCACGTGGGTCAATGGCTCTGA
GGAATGCAGGAGGAACGATGTTCA -> GAATGCAGGAGGAACGATGTTCAT
CTTCGCTAGTTTCCGCGGTACGAC -> TTCGCTAGTTTCCGCGGTACGACT
TTAGGAAACTCACAGCTAACATGA -> TAGGAAACTCACAGCTAACATGAA
TTGAGTTGAGTAGGCCCAATGCGG -> TGAGTTGAGTAGGCCCAATGCGGC
AGTAGGCCCAATGCGGCCGCCCTT -> GTAGGCCCAATGCGGCCGCCCTTA
AAAGTTTGACAGGCGCCTTGATAA -> AAGTTTGACAGGCGCCTTGATAAT
TCCGCTGAGCGCGTAGGAGCTTTT -> CCGCTGAGCGCGTAGGAGCTTTTA
TCCGGCTGTACTCTGGCGGGGCCA -> CCGGCTGTACTCTGGCGGGGCCAC
CGAGCTTTGCTGGCCTTCGCTAGT -> GAGCTTTGCTGGCCTTCGCTAGTT
GAACAAACTGGTCAGTTCTACACA -> AACAAACTGGTCAGTTCTACACAA
CTATCCTTTAAAGGATCAAGCCCC -> TATCCTTTAAAGGATCAAGCCCCA
GTGGAACTATTTTACGCATGCGAG -> TGGAACTATTTTACGCATGCGAGA
GCAAGACTGGGACGACTAGTAAAC -> CAAGACTGGGACGACTAGTAAACT
TGGGTAGTAATATGTTCGTAAAAT -> GGGTAGTAATATGTTCGTAAAATA
ATGCGAAGCGGGAGCCAAGTCATA -> TGCGAAGCGGGAGCCAAGTCATAA
AAGGTTCTGCTGTCGGGGGTTGTA -> AGGTTCTGCTGTCGGGGGTTGTAG
CTGATCTCTGTACACATGCGAAGC -> TGATCTCTGTACACATGCGAAGCG
CCCCTATACGAGACGCTCAGCGAT -> CCCTATACGAGACGCTCAGCGATG
TAAAGGATCAAGCCCCAGCGCCGA -> AAAGGATCAAGCCCCAGCGCCGAG
TGTTCGTAAAATAGCCGTCGCGGA -> GTTCGTAAAATAGCCGTCGCGGAT
CCTCACTTAACGGGGAATGCAGGA -> CTCACTTAACGGGGAATGCAGGAG
CCGCGGTACGACTTGTGAATGCAA -> CGCGGTACGACTTGTGAATGCAAA
GGTGGAGCGTCTAAAACGACCTAG -> GTGGAGCGTCTAAAACGACCTAGA
CGTCCGGTAAGTACTTGACGTTTC -> GTCCGGTAAGTACTTGACGTTTCC
TCACGTGAACATTGTCTAATTGCC -> CACGTGAACATTGTCTAATTGCCT
GTCCCCGACTTAAGGTTCTGCTGT -> TCCCCGACTTAAGGTTCTGCTGTC
TAGTTATTCCGTAGTCTTTATGCA -> AGTTATTCCGTAGTCTTTATGCAG
AACTAGGGCGAAATCGTCTCTTTT -> ACTAGGGCGAAATCGTCTCTTTTC
TGCTAGTTCAGAATTCTTGCAGTG -> GCTAGTTCAGAATTCTTGCAGTGG
TATGTATAGCAATTTCATGTTATC -> ATGTATAGCAATTTCATGTTATCC
AAGTTTGACAGGCGCCTTGATAAT -> AGTTTGACAGGCGCCTTGATAATG
TTAGTTTACAGTGATTATAGGCAG -> TAGTTTACAGTGATTATAGGCAGG
ACGTGGTCCGGGCTGGAAGTGTCG -> CGTGGTCCGGGCTGGAAGTGTCGG
TTAGGCGCTCCTAATGGCCAACTA -> TAGGCGCTCCTAATGGCCAACTAG
GCTGAGCGCGTAGGAGCTTTTAGT -> CTGAGCGCGTAGGAGCTTTTAGTA
CCTCCCAACTTGACAGCAAGACTG -> CTCCCAACTTGACAGCAAGACTGG
CCACCAGTTGCGAGGACAGGAATC -> CACCAGTTGCGAGGACAGGAATCT
CCATCGGACGGTGCGGCTCTGGCC -> CATCGGACGGTGCGGCTCTGGCCT
TAGTAAACTCGTTGCACAACTACA -> AGTAAACTCGTTGCACAACTACAC
CACGTGAACATTGTCTAATTGCCT -> ACGTGAACATTGTCTAATTGCCTC
CAGGTGGAGCGTCTAAAACGACCT -> AGGTGGAGCGTCTAAAACGACCTA
GGCATTGTGCCACCATGCTCCTTG -> GCATTGTGCCACCATGCTCCTTGC
CGTGCAGGTGTTTAGGTACACCGG -> GTGCAGGTGTTTAGGTACACCGGT
TATATAAAGATATGTCGTTTGCTA -> ATATAAAGATATGTCGTTTGCTAA
CACAGCTAACATGAACGCGACGCT -> ACAGCTAACATGAACGCGACGCTA
ACGCATGCGAGACATTAGCTGAAT -> CGCATGCGAGACATTAGCTGAATT
CCAAGTCATAAATCCGCCTGACTT -> CAAGTCATAAATCCGCCTGACTTT
ATTCCCCAACCTCAAGCATAGAGT -> TTCCCCAACCTCAAGCATAGAGTA
AGGCGCTCCTAATGGCCAACTAGG -> GGCGCTCCTAATGGCCAACTAGGG
ATGTTATCCACTTGCCCAACGGCT -> TGTTATCCACTTGCCCAACGGCTT
GAATTCTTGCAGTGGAACTATTTT -> AATTCTTGCAGTGGAACTATTTTA
TCTTATACCAACAGTGTACCAAAG -> CTTATACCAACAGTGTACCAAAGG
CTTTTCGTCGTATGAGTAGTGTTC -> TTTTCGTCGTATGAGTAGTGTTCG
AGGCAGGTTAGTGCGCATTACAGG -> GGCAGGTTAGTGCGCATTACAGGT
GTCGGGGGTTGTAGGGGTGCATAG -> TCGGGGGTTGTAGGGGTGCATAGA
TCCCCCCTATACGAGACGCTCAGC -> CCCCCCTATACGAGACGCTCAGCG
GCTGTGTAAAGTTTGACAGGCGCC -> CTGTGTAAAGTTTGACAGGCGCCT
AGCTGAATTGTGTTGGGTAGTAAT -> GCTGAATTGTGTTGGGTAGTAATA
TCGCGGGATATAAACACTGGAGAA -> CGCGGGATATAAACACTGGAGAAC
TTGCGAGGACAGGAATCTCGGATC -> TGCGAGGACAGGAATCTCGGATCC
TAGAGGGGAAGCTAGTGATGGTTG -> AGAGGGGAAGCTAGTGATGGTTGT
ATACGAGACGCTCAGCGATGGTAA -> TACGAGACGCTCAGCGATGGTAAG
AGTCCCACGTGGGTCAATGGCTCT -> GTCCCACGTGGGTCAATGGCTCTG
CGCTCGTCTATTTTACGGATTCTC -> GCTCGTCTATTTTACGGATTCTCT
TTGGTATAAAGATCCCCCCTATAC -> TGGTATAAAGATCCCCCCTATACG
CCAACTAGGGCGAAATCGTCTCTT -> CAACTAGGGCGAAATCGTCTCTTT
ATTCCATAGCGAGCCTATATTAGG -> TTCCATAGCGAGCCTATATTAGGC
CTGGGACGACTAGTAAACTCGTTG -> TGGGACGACTAGTAAACTCGTTGC
TATGCAGCACGTCCGGTAAGTACT -> ATGCAGCACGTCCGGTAAGTACTT
ACTGATCTCTGTACACATGCGAAG -> CTGATCTCTGTACACATGCGAAGC
CCTATACGAGACGCTCAGCGATGG -> CTATACGAGACGCTCAGCGATGGT
CTAGTTCAGAATTCTTGCAGTGGA -> TAGTTCAGAATTCTTGCAGTGGAA
ACACAAAACCTACGTATGGCTTGA -> CACAAAACCTACGTATGGCTTGAG
AACGGGGTTTAGTTTACAGTGATT -> ACGGGGTTTAGTTTACAGTGATTA
CGGACATAGAGGGGAAGCTAGTGA -> GGACATAGAGGGGAAGCTAGTGAT
CGGCTGTGTAAAGTTTGACAGGCG -> GGCTGTGTAAAGTTTGACAGGCGC
GATGGTTGTTAGAGCATTCCCCAA -> ATGGTTGTTAGAGCATTCCCCAAC
AGCTTATCCGCCGATCGGGATCCA -> GCTTATCCGCCGATCGGGATCCAC
GAGCATTCCCCAACCTCAAGCATA -> AGCATTCCCCAACCTCAAGCATAG
TTTTCATTAGGAAACTCACAGCTA -> TTTCATTAGGAAACTCACAGCTAA
CGGCTCATCCAGCTCTATGTATAG -> GGCTCATCCAGCTCTATGTATAGC
TCGTATGAGTAGTGTTCGTGCAGG -> CGTATGAGTAGTGTTCGTGCAGGT
GTGCGGCTCTGGCCTTAATGCATG -> TGCGGCTCTGGCCTTAATGCATGG
ATGCAGCCAAGCTCGAGAATCTCC -> TGCAGCCAAGCTCGAGAATCTCCG
CTCGCACGACACTTACGAGCTGCT -> TCGCACGACACTTACGAGCTGCTC
GCCCTGATTGAAGACGTGGTCCGG -> CCCTGATTGAAGACGTGGTCCGGG
CTCGTCTATTTTACGGATTCTCTA -> TCGTCTATTTTACGGATTCTCTAC
AGTTAAGTCCGAGGAGCTTTGCAT -> GTTAAGTCCGAGGAGCTTTGCATC
ATGTTCATAATTTCTTACGACTAG -> TGTTCATAATTTCTTACGACTAGT
TTGACGTTTCCGTACTCACCGCGC -> TGACGTTTCCGTACTCACCGCGCC
CGGGGGTTGTAGGGGTGCATAGAC -> GGGGGTTGTAGGGGTGCATAGACG
TCTCGGCATTGTGCCACCATGCTC -> CTCGGCATTGTGCCACCATGCTCC
TTATACTTGTATCGCGGGATATAA -> TATACTTGTATCGCGGGATATAAA
GCATTGTGCCACCATGCTCCTTGC -> CATTGTGCCACCATGCTCCTTGCG
AATTGCCTCCAAATTTACATTGGT -> ATTGCCTCCAAATTTACATTGGTC
CCGATATGGAACAAACTGGTCAGT -> CGATATGGAACAAACTGGTCAGTT
GGCCGTATTGGTATAAAGATCCCC -> GCCGTATTGGTATAAAGATCCCCC
ATCGGACGGTGCGGCTCTGGCCTT -> TCGGACGGTGCGGCTCTGGCCTTA
TTATCCGCCGATCGGGATCCACGC -> TATCCGCCGATCGGGATCCACGCC
AAGTGTCGGCCGTGATTAGAAAAG -> AGTGTCGGCCGTGATTAGAAAAGG
GCGCCTTGATAATGCGACTTACCA -> CGCCTTGATAATGCGACTTACCAA
CACCACACGTCCCCGACTTAAGGT -> ACCACACGTCCCCGACTTAAGGTT
ATAACTGATCTCTGTACACATGCG -> TAACTGATCTCTGTACACATGCGA
GGCCCAATGCGGCCGCCCTTACGG -> GCCCAATGCGGCCGCCCTTACGGA
GTAAGTACTTGACGTTTCCGTACT -> TAAGTACTTGACGTTTCCGTACTC
CTCCTAATGGCCAACTAGGGCGAA -> TCCTAATGGCCAACTAGGGCGAAA
TGACGTTTCCGTACTCACCGCGCC -> GACGTTTCCGTACTCACCGCGCCT
CACTGGAGAACCAAGCGGAGAATT -> ACTGGAGAACCAAGCGGAGAATTA
ACTAGGGCTGACGCTCGTCTATTT -> CTAGGGCTGACGCTCGTCTATTTT
AACCTCAAGCATAGAGTATCGATT -> ACCTCAAGCATAGAGTATCGATTT
TTGTCTAATTGCCTCCAAATTTAC -> TGTCTAATTGCCTCCAAATTTACA
CTCGTTGCACAACTACACTAGGGC -> TCGTTGCACAACTACACTAGGGCT
TGATTGAAGACGTGGTCCGGGCTG -> GATTGAAGACGTGGTCCGGGCTGG
GAATCTCCGGGCGCGATGGCCGGA -> AATCTCCGGGCGCGATGGCCGGAC
GGTGCATAGACGGCTGTGTAAAGT -> GTGCATAGACGGCTGTGTAAAGTT
ATGGACCAGTGCTAGTTCAGAATT -> TGGACCAGTGCTAGTTCAGAATTC
TACCAAGGCGCGTGTCCAAAAGGT -> ACCAAGGCGCGTGTCCAAAAGGTG
CCGCGCCTAAAGTGGCCGTATTGG -> CGCGCCTAAAGTGGCCGTATTGGT
TAGGTACACCGGTAAAAGATGAAT -> AGGTACACCGGTAAAAGATGAATA
TCCCAACTTGACAGCAAGACTGGG -> CCCAACTTGACAGCAAGACTGGGA
TTAATTTTGGGCATCAAGTAGAGC -> TAATTTTGGGCATCAAGTAGAGCA
TTAAGTAATGAATCAACACTGATT -> TAAGTAATGAATCAACACTGATTC
GGCTGTACTCTGGCGGGGCCACAC -> GCTGTACTCTGGCGGGGCCACACA
TCTTTTAATTGCGCACGTAAAATT -> CTTTTAATTGCGCACGTAAAATTT
GCTCTGAGCTTATCCGCCGATCGG -> CTCTGAGCTTATCCGCCGATCGGG
CCGTATTGGTATAAAGATCCCCCC -> CGTATTGGTATAAAGATCCCCCCT
CTATGTATAGCAATTTCATGTTAT -> TATGTATAGCAATTTCATGTTATC
TGGTCTTTTAATTGCGCACGTAAA -> GGTCTTTTAATTGCGCACGTAAAA
TCCGCGGTACGACTTGTGAATGCA -> CCGCGGTACGACTTGTGAATGCAA
CCTAAAGTGGCCGTATTGGTATAA -> CTAAAGTGGCCGTATTGGTATAAA
TCCGTTCCGATATGGAACAAACTG -> CCGTTCCGATATGGAACAAACTGG
GTGTTCGTGCAGGTGTTTAGGTAC -> TGTTCGTGCAGGTGTTTAGGTACA
TCCACTTGCCCAACGGCTTACCTA -> CCACTTGCCCAACGGCTTACCTAG
AAACTCGTTGCACAACTACACTAG -> AACTCGTTGCACAACTACACTAGG
GCAATTTCATGTTATCCACTTGCC -> CAATTTCATGTTATCCACTTGCCC
CAAATTTACATTGGTCCGGCTGTA -> AAATTTACATTGGTCCGGCTGTAC
CAAAAGCCATTGGCCCTTGTGAAT -> AAAAGCCATTGGCCCTTGTGAATC
GCGATTCCATCGGACGGTGCGGCT -> CGATTCCATCGGACGGTGCGGCTC
GGATCAAGCCCCAGCGCCGAGGTG -> GATCAAGCCCCAGCGCCGAGGTGC
TGCGACTTACCAAGGCGCGTGTCC -> GCGACTTACCAAGGCGCGTGTCCA
CTTGATACAACGCCCCTCACGTGG -> TTGATACAACGCCCCTCACGTGGT
TGAGCTTATCCGCCGATCGGGATC -> GAGCTTATCCGCCGATCGGGATCC
CCCTCACGTGGTCTTTTAATTGCG -> CCTCACGTGGTCTTTTAATTGCGC
ATGTATAGCAATTTCATGTTATCC -> TGTATAGCAATTTCATGTTATCCA
AGGTTAGTGCGCATTACAGGTGGA -> GGTTAGTGCGCATTACAGGTGGAG
AAGATATGTCGTTTGCTAAACTAC -> AGATATGTCGTTTGCTAAACTACC
CGCTGAGCGCGTAGGAGCTTTTAG -> GCTGAGCGCGTAGGAGCTTTTAGT
AGCAATCCGGCTCATCCAGCTCTA -> GCAATCCGGCTCATCCAGCTCTAT
GCTGGCGAACCCTAGTAGGCTCTT -> CTGGCGAACCCTAGTAGGCTCTTC
CGCATTACAGGTGGAGCGTCTAAA -> GCATTACAGGTGGAGCGTCTAAAA
GATGGCCGGACATAGAGGGGAAGC -> ATGGCCGGACATAGAGGGGAAGCT
TCCCGCGAGTTAATTTTGGGCATC -> CCCGCGAGTTAATTTTGGGCATCA
AGTTCAGAATTCTTGCAGTGGAAC -> GTTCAGAATTCTTGCAGTGGAACT
CTTTTCATTAGGAAACTCACAGCT -> TTTTCATTAGGAAACTCACAGCTA
CTAGGGCGAAATCGTCTCTTTTCG -> TAGGGCGAAATCGTCTCTTTTCGT
ACCACACGTCCCCGACTTAAGGTT -> CCACACGTCCCCGACTTAAGGTTC
CCCTAGATTCCATAGCGAGCCTAT -> CCTAGATTCCATAGCGAGCCTATA
GTGATGGTTGTTAGAGCATTCCCC -> TGATGGTTGTTAGAGCATTCCCCA
GCGAAGCGGGAGCCAAGTCATAAA -> CGAAGCGGGAGCCAAGTCATAAAT
AATACGTCAATTATGAAGCTCTTG -> ATACGTCAATTATGAAGCTCTTGA
CAGGAGGAACGATGTTCATAATTT -> AGGAGGAACGATGTTCATAATTTC
AATTATGAAGCTCTTGACGTTTCA -> ATTATGAAGCTCTTGACGTTTCAC
CTGATTGAAGACGTGGTCCGGGCT -> TGATTGAAGACGTGGTCCGGGCTG
GAGGTGCCTCACTTAACGGGGAAT -> AGGTGCCTCACTTAACGGGGAATG
CCTGGTCTCGGCATTGTGCCACCA -> CTGGTCTCGGCATTGTGCCACCAT
TCCACCAGTTGCGAGGACAGGAAT -> CCACCAGTTGCGAGGACAGGAATC
CTTGACAGCAAGACTGGGACGACT -> TTGACAGCAAGACTGGGACGACTA
CCCACGTGGGTCAATGGCTCTGAG -> CCACGTGGGTCAATGGCTCTGAGC
AGACGTGGTCCGGGCTGGAAGTGT -> GACGTGGTCCGGGCTGGAAGTGTC
TGTAGGGGTGCATAGACGGCTGTG -> GTAGGGGTGCATAGACGGCTGTGT
TAGCCAAGGATGCGAAGGATCTCA -> AGCCAAGGATGCGAAGGATCTCAC
GCAGGAGGAACGATGTTCATAATT -> CAGGAGGAACGATGTTCATAATTT
TTTGGGCATCAAGTAGAGCAAATA -> TTGGGCATCAAGTAGAGCAAATAC
TAGAGCATTCCCCAACCTCAAGCA -> AGAGCATTCCCCAACCTCAAGCAT
CTCCGGTAAAGCAATCCGGCTCAT -> TCCGGTAAAGCAATCCGGCTCATC
GAAGGATCTCACGTGAACATTGTC -> AAGGATCTCACGTGAACATTGTCT
TGCAGGAGGAACGATGTTCATAAT -> GCAGGAGGAACGATGTTCATAATT
CAGCTCTATGTATAGCAATTTCAT -> AGCTCTATGTATAGCAATTTCATG
ACGGCTTACCTAGGAGTCCCACGT -> CGGCTTACCTAGGAGTCCCACGTG
ATACGTCAATTATGAAGCTCTTGA -> TACGTCAATTATGAAGCTCTTGAC
TTACATTGGTCCGGCTGTACTCTG -> TACATTGGTCCGGCTGTACTCTGG
CCGGCTGTACTCTGGCGGGGCCAC -> CGGCTGTACTCTGGCGGGGCCACA
TAGCGAGCCTATATTAGGCGCTCC -> AGCGAGCCTATATTAGGCGCTCCT
TAACTGATCTCTGTACACATGCGA -> AACTGATCTCTGTACACATGCGAA
GGCCAACTAGGGCGAAATCGTCTC -> GCCAACTAGGGCGAAATCGTCTCT
CTTGCGAGCGGCCAACCTATCCTT -> TTGCGAGCGGCCAACCTATCCTTT
GATCTCTGTACACATGCGAAGCGG -> ATCTCTGTACACATGCGAAGCGGG
GTACCAAAGGCATACTGCTGGCGA -> TACCAAAGGCATACTGCTGGCGAA
GCGGGAGCCAAGTCATAAATCCGC -> CGGGAGCCAAGTCATAAATCCGCC
GAGCTTTGCATCTTATACCAACAG -> AGCTTTGCATCTTATACCAACAGT
TCTCACGTGAACATTGTCTAATTG -> CTCACGTGAACATTGTCTAATTGC
ATACTTGTATCGCGGGATATAAAC -> TACTTGTATCGCGGGATATAAACA
TAATGCATGGCTCGCACGACACTT -> AATGCATGGCTCGCACGACACTTA
CGAGGTGCCTCACTTAACGGGGAA -> GAGGTGCCTCACTTAACGGGGAAT
AGGAATCTCGGATCCCTAGATTCC -> GGAATCTCGGATCCCTAGATTCCA
GGGGAAGCTAGTGATGGTTGTTAG -> GGGAAGCTAGTGATGGTTGTTAGA
CCAAGGCGCGTGTCCAAAAGGTGT -> CAAGGCGCGTGTCCAAAAGGTGTT
ACTGGGACGACTAGTAAACTCGTT -> CTGGGACGACTAGTAAACTCGTTG
GATGCGAAGGATCTCACGTGAACA -> ATGCGAAGGATCTCACGTGAACAT
CTAATTGCCTCCAAATTTACATTG -> TAATTGCCTCCAAATTTACATTGG
CGGATGGTCGAAGTCCAGTCCCGC -> GGATGGTCGAAGTCCAGTCCCGCG
GCTCCTAATGGCCAACTAGGGCGA -> CTCCTAATGGCCAACTAGGGCGAA
AAACTACCTTAATATAAGATCGAG -> AACTACCTTAATATAAGATCGAGG
CAACTACACTAGGGCTGACGCTCG -> AACTACACTAGGGCTGACGCTCGT
TTTCACCACACGTCCCCGACTTAA -> TTCACCACACGTCCCCGACTTAAG
GTAATATGTTCGTAAAATAGCCGT -> TAATATGTTCGTAAAATAGCCGTC
CCTATATTAGGCGCTCCTAATGGC -> CTATATTAGGCGCTCCTAATGGCC
ATGGAACAAACTGGTCAGTTCTAC -> TGGAACAAACTGGTCAGTTCTACA
CGGTAAGTACTTGACGTTTCCGTA -> GGTAAGTACTTGACGTTTCCGTAC
AATTTACATTGGTCCGGCTGTACT -> ATTTACATTGGTCCGGCTGTACTC
CATAGAGTATCGATTTCCACCAGT -> ATAGAGTATCGATTTCCACCAGTT
GGTAAGTACTTGACGTTTCCGTAC -> GTAAGTACTTGACGTTTCCGTACT
TAGGGCTGACGCTCGTCTATTTTA -> AGGGCTGACGCTCGTCTATTTTAC
TCTACACAAAACCTACGTATGGCT -> CTACACAAAACCTACGTATGGCTT
CTATAGTTATTCCGTAGTCTTTAT -> TATAGTTATTCCGTAGTCTTTATG
ATCCAGCTCTATGTATAGCAATTT -> TCCAGCTCTATGTATAGCAATTTC
AAGCTCTTGACGTTTCACCACACG -> AGCTCTTGACGTTTCACCACACGT
CAATCCGGCTCATCCAGCTCTATG -> AATCCGGCTCATCCAGCTCTATGT
GGAGCTTTTAGTACCGAGTTCGGT -> GAGCTTTTAGTACCGAGTTCGGTA
ATCAAGTAGAGCAAATACCCGCTT -> TCAAGTAGAGCAAATACCCGCTTT
GGATGCGAAGGATCTCACGTGAAC -> GATGCGAAGGATCTCACGTGAACA
AAGATCGAGGCTTAGTCCACGACC -> AGATCGAGGCTTAGTCCACGACCT
CCAAATTTACATTGGTCCGGCTGT -> CAAATTTACATTGGTCCGGCTGTA
TTTAGGTACACCGGTAAAAGATGA -> TTAGGTACACCGGTAAAAGATGAA
AGCCGTCGCGGATCCACAGGCCCT -> GCCGTCGCGGATCCACAGGCCCTG
TTTACATTGGTCCGGCTGTACTCT -> TTACATTGGTCCGGCTGTACTCTG
TTACGCATGCGAGACATTAGCTGA -> TACGCATGCGAGACATTAGCTGAA
AGCAAGACTGGGACGACTAGTAAA -> GCAAGACTGGGACGACTAGTAAAC
GCGACTTACCAAGGCGCGTGTCCA -> CGACTTACCAAGGCGCGTGTCCAA
GAGCGGCCAACCTATCCTTTAAAG -> AGCGGCCAACCTATCCTTTAAAGG
ACCTACGTATGGCTTGAGTTGAGT -> CCTACGTATGGCTTGAGTTGAGTA
CTCTCCGCTGAGCGCGTAGGAGCT -> TCTCCGCTGAGCGCGTAGGAGCTT
TCATAATTTCTTACGACTAGTTCC -> CATAATTTCTTACGACTAGTTCCT
ACGACCTAATACTTAACCTTCTCT -> CGACCTAATACTTAACCTTCTCTC
GTTTACAGTGATTATAGGCAGGTT -> TTTACAGTGATTATAGGCAGGTTA
GGAAGCTAGTGATGGTTGTTAGAG -> GAAGCTAGTGATGGTTGTTAGAGC
ATACTTAACCTTCTCTCCGCTGAG -> TACTTAACCTTCTCTCCGCTGAGC
TCCCCGACTTAAGGTTCTGCTGTC -> CCCCGACTTAAGGTTCTGCTGTCG
GAATCAACACTGATTCCTGGTCTC -> AATCAACACTGATTCCTGGTCTCG
CTTTCTATAGTTATTCCGTAGTCT -> TTTCTATAGTTATTCCGTAGTCTT
GCGCCTAAAGTGGCCGTATTGGTA -> CGCCTAAAGTGGCCGTATTGGTAT
ATCCACGCCGTGTATATAAAGATA -> TCCACGCCGTGTATATAAAGATAT
TGCGAGACATTAGCTGAATTGTGT -> GCGAGACATTAGCTGAATTGTGTT
TGGTCTCGGCATTGTGCCACCATG -> GGTCTCGGCATTGTGCCACCATGC
AATGCAGGAGGAACGATGTTCATA -> ATGCAGGAGGAACGATGTTCATAA
TAGAGTATCGATTTCCACCAGTTG -> AGAGTATCGATTTCCACCAGTTGC
AATTTTGGGCATCAAGTAGAGCAA -> ATTTTGGGCATCAAGTAGAGCAAA
TGTATCGCGGGATATAAACACTGG -> GTATCGCGGGATATAAACACTGGA
TGCGAGCGGCCAACCTATCCTTTA -> GCGAGCGGCCAACCTATCCTTTAA
CTTAAGGTTCTGCTGTCGGGGGTT -> TTAAGGTTCTGCTGTCGGGGGTTG
ACATTAGCTGAATTGTGTTGGGTA -> CATTAGCTGAATTGTGTTGGGTAG
CCAAGGATGCGAAGGATCTCACGT -> CAAGGATGCGAAGGATCTCACGTG
GCTCGGTCATTACTAGAATACGTC -> CTCGGTCATTACTAGAATACGTCA
TATAGCAATTTCATGTTATCCACT -> ATAGCAATTTCATGTTATCCACTT
AATCCGCCTGACTTTCTATAGTTA -> ATCCGCCTGACTTTCTATAGTTAT
CTTAGTCCACGACCTAATACTTAA -> TTAGTCCACGACCTAATACTTAAC
TCGTCTATTTTACGGATTCTCTAC -> CGTCTATTTTACGGATTCTCTACA
GGTTCTGCTGTCGGGGGTTGTAGG -> GTTCTGCTGTCGGGGGTTGTAGGG
AAGACTGGGACGACTAGTAAACTC -> AGACTGGGACGACTAGTAAACTCG
GTGCTAGTTCAGAATTCTTGCAGT -> TGCTAGTTCAGAATTCTTGCAGTG
TAGCAATTTCATGTTATCCACTTG -> AGCAATTTCATGTTATCCACTTGC
GCTCCTTGCGAGCGGCCAACCTAT -> CTCCTTGCGAGCGGCCAACCTATC
GTCGTTTGCTAAACTACCTTAATA -> TCGTTTGCTAAACTACCTTAATAT
TATCCTTTAAAGGATCAAGCCCCA -> ATCCTTTAAAGGATCAAGCCCCAG
AGGGCGAAATCGTCTCTTTTCGTC -> GGGCGAAATCGTCTCTTTTCGTCG
ACTTACCAAGGCGCGTGTCCAAAA -> CTTACCAAGGCGCGTGTCCAAAAG
ATCTCGGATCCCTAGATTCCATAG -> TCTCGGATCCCTAGATTCCATAGC
GTATGAGTAGTGTTCGTGCAGGTG -> TATGAGTAGTGTTCGTGCAGGTGT
CTCACGTGAACATTGTCTAATTGC -> TCACGTGAACATTGTCTAATTGCC
CCCTATACGAGACGCTCAGCGATG -> CCTATACGAGACGCTCAGCGATGG
ACGACACTTACGAGCTGCTCCGAT -> CGACACTTACGAGCTGCTCCGATC
TAGTCCACGACCTAATACTTAACC -> AGTCCACGACCTAATACTTAACCT
CCAACGGCTTACCTAGGAGTCCCA -> CAACGGCTTACCTAGGAGTCCCAC
AGGTGTTCAGCGATTCCATCGGAC -> GGTGTTCAGCGATTCCATCGGACG
GGGTTTAGTTTACAGTGATTATAG -> GGTTTAGTTTACAGTGATTATAGG
GCTGTCGGGGGTTGTAGGGGTGCA -> CTGTCGGGGGTTGTAGGGGTGCAT
CCTAGTAGGCTCTTCCGTTCCGAT -> CTAGTAGGCTCTTCCGTTCCGATA
CTGACGCTCGTCTATTTTACGGAT -> TGACGCTCGTCTATTTTACGGATT
GTAGTCTTTATGCAGCACGTCCGG -> TAGTCTTTATGCAGCACGTCCGGT
TGCGCATTACAGGTGGAGCGTCTA -> GCGCATTACAGGTGGAGCGTCTAA
GCCACACAATGGACCAGTGCTAGT -> CCACACAATGGACCAGTGCTAGTT
GCTAGTTCAGAATTCTTGCAGTGG -> CTAGTTCAGAATTCTTGCAGTGGA
CTGAGCTTATCCGCCGATCGGGAT -> TGAGCTTATCCGCCGATCGGGATC
CGGCTGTACTCTGGCGGGGCCACA -> GGCTGTACTCTGGCGGGGCCACAC
CGGCTCTGGCCTTAATGCATGGCT -> GGCTCTGGCCTTAATGCATGGCTC
AACGGGGAATGCAGGAGGAACGAT -> ACGGGGAATGCAGGAGGAACGATG
GCTCTTGACGTTTCACCACACGTC -> CTCTTGACGTTTCACCACACGTCC
CGCCGTGTATATAAAGATATGTCG -> GCCGTGTATATAAAGATATGTCGT
CCGATCGGGATCCACGCCGTGTAT -> CGATCGGGATCCACGCCGTGTATA
GGCCAACCTATCCTTTAAAGGATC -> GCCAACCTATCCTTTAAAGGATCA
TAGTCTTTATGCAGCACGTCCGGT -> AGTCTTTATGCAGCACGTCCGGTA
TCTATGTATAGCAATTTCATGTTA -> CTATGTATAGCAATTTCATGTTAT
AAAGGATCAAGCCCCAGCGCCGAG -> AAGGATCAAGCCCCAGCGCCGAGG
AGCGGCCAACCTATCCTTTAAAGG -> GCGGCCAACCTATCCTTTAAAGGA
GGCGCGATGGCCGGACATAGAGGG -> GCGCGATGGCCGGACATAGAGGGG
TACAATGCAGCCAAGCTCGAGAAT -> ACAATGCAGCCAAGCTCGAGAATC
TCCGAGGAGCTTTGCATCTTATAC -> CCGAGGAGCTTTGCATCTTATACC
CGGCATTGTGCCACCATGCTCCTT -> GGCATTGTGCCACCATGCTCCTTG
CGAGAATCTCCGGGCGCGATGGCC -> GAGAATCTCCGGGCGCGATGGCCG
GACAGCAAGACTGGGACGACTAGT -> ACAGCAAGACTGGGACGACTAGTA
TATGAGTAGTGTTCGTGCAGGTGT -> ATGAGTAGTGTTCGTGCAGGTGTT
ACTAGAATACGTCAATTATGAAGC -> CTAGAATACGTCAATTATGAAGCT
CATTAGGAAACTCACAGCTAACAT -> ATTAGGAAACTCACAGCTAACATG
AGTACTTGACGTTTCCGTACTCAC -> GTACTTGACGTTTCCGTACTCACC
CACAATGGACCAGTGCTAGTTCAG -> ACAATGGACCAGTGCTAGTTCAGA
AAATTTACATTGGTCCGGCTGTAC -> AATTTACATTGGTCCGGCTGTACT
AAAATAGCCGTCGCGGATCCACAG -> AAATAGCCGTCGCGGATCCACAGG
AAACACTGGAGAACCAAGCGGAGA -> AACACTGGAGAACCAAGCGGAGAA
GAAGCGGGAGCCAAGTCATAAATC -> AAGCGGGAGCCAAGTCATAAATCC
AGAAAAGGCGCTCGGTCATTACTA -> GAAAAGGCGCTCGGTCATTACTAG
ATAATGCGACTTACCAAGGCGCGT -> TAATGCGACTTACCAAGGCGCGTG
AACCTACGTATGGCTTGAGTTGAG -> ACCTACGTATGGCTTGAGTTGAGT
GCTTACAATGCAGCCAAGCTCGAG -> CTTACAATGCAGCCAAGCTCGAGA
AGTCCACGACCTAATACTTAACCT -> GTCCACGACCTAATACTTAACCTT
ACTTGATACAACGCCCCTCACGTG -> CTTGATACAACGCCCCTCACGTGG
CTATACGAGACGCTCAGCGATGGT -> TATACGAGACGCTCAGCGATGGTA
TCTTTTCGTCGTATGAGTAGTGTT -> CTTTTCGTCGTATGAGTAGTGTTC
TACAAACGGGGTTTAGTTTACAGT -> ACAAACGGGGTTTAGTTTACAGTG
CGTCAATTATGAAGCTCTTGACGT -> GTCAATTATGAAGCTCTTGACGTT
GTTAAGTCCGAGGAGCTTTGCATC -> TTAAGTCCGAGGAGCTTTGCATCT
TATTTTACGGATTCTCTACAAACG -> ATTTTACGGATTCTCTACAAACGG
CTGTGTAAAGTTTGACAGGCGCCT -> TGTGTAAAGTTTGACAGGCGCCTT
TCCCCAACCTCAAGCATAGAGTAT -> CCCCAACCTCAAGCATAGAGTATC
TTTTACGCATGCGAGACATTAGCT -> TTTACGCATGCGAGACATTAGCTG
ACTTAACGGGGAATGCAGGAGGAA -> CTTAACGGGGAATGCAGGAGGAAC
ATCCGCCTGACTTTCTATAGTTAT -> TCCGCCTGACTTTCTATAGTTATT
CAAGGATGCGAAGGATCTCACGTG -> AAGGATGCGAAGGATCTCACGTGA
CCAAAAGGTGTTCAGCGATTCCAT -> CAAAAGGTGTTCAGCGATTCCATC
GTCCCGCGAGTTAATTTTGGGCAT -> TCCCGCGAGTTAATTTTGGGCATC
GCTCCGATCAATAACTGATCTCTG -> CTCCGATCAATAACTGATCTCTGT
AGTTCTACACAAAACCTACGTATG -> GTTCTACACAAAACCTACGTATGG
GAGGAGCTTTGCATCTTATACCAA -> AGGAGCTTTGCATCTTATACCAAC
CGGCTTACCTAGGAGTCCCACGTG -> GGCTTACCTAGGAGTCCCACGTGG
AGCTCGAGAATCTCCGGGCGCGAT -> GCTCGAGAATCTCCGGGCGCGATG
GTCCGGTAAGTACTTGACGTTTCC -> TCCGGTAAGTACTTGACGTTTCCG
ACCAAGCGGAGAATTAAGTAATGA -> CCAAGCGGAGAATTAAGTAATGAA
TCTTGACGTTTCACCACACGTCCC -> CTTGACGTTTCACCACACGTCCCC
GGAACGATGTTCATAATTTCTTAC -> GAACGATGTTCATAATTTCTTACG
GACGCTCGTCTATTTTACGGATTC -> ACGCTCGTCTATTTTACGGATTCT
TAGTGTTCGTGCAGGTGTTTAGGT -> AGTGTTCGTGCAGGTGTTTAGGTA
GTGTTGGGTAGTAATATGTTCGTA -> TGTTGGGTAGTAATATGTTCGTAA
AGGAACGATGTTCATAATTTCTTA -> GGAACGATGTTCATAATTTCTTAC
CTGGTCAGTTCTACACAAAACCTA -> TGGTCAGTTCTACACAAAACCTAC
TAGCCGTCGCGGATCCACAGGCCC -> AGCCGTCGCGGATCCACAGGCCCT
AGAATTCTTGCAGTGGAACTATTT -> GAATTCTTGCAGTGGAACTATTTT
GAGAACCAAGCGGAGAATTAAGTA -> AGAACCAAGCGGAGAATTAAGTAA
CCTAGGAGTCCCACGTGGGTCAAT -> CTAGGAGTCCCACGTGGGTCAATG
ATAGCGAGCCTATATTAGGCGCTC -> TAGCGAGCCTATATTAGGCGCTCC
GCCTTCGCTAGTTTCCGCGGTACG -> CCTTCGCTAGTTTCCGCGGTACGA
AAGATGAATAGCCAAGGATGCGAA -> AGATGAATAGCCAAGGATGCGAAG
ATTCTCTACAAACGGGGTTTAGTT -> TTCTCTACAAACGGGGTTTAGTTT
GAGTTAATTTTGGGCATCAAGTAG -> AGTTAATTTTGGGCATCAAGTAGA
CCGAGTTCGGTAAGCAATTGCCAT -> CGAGTTCGGTAAGCAATTGCCATG
CACACGTCCCCGACTTAAGGTTCT -> ACACGTCCCCGACTTAAGGTTCTG
AAAGATCCCCCCTATACGAGACGC -> AAGATCCCCCCTATACGAGACGCT
CAAACTGGTCAGTTCTACACAAAA -> AAACTGGTCAGTTCTACACAAAAC
TTATACCAACAGTGTACCAAAGGC -> TATACCAACAGTGTACCAAAGGCA
TGAATTGTGTTGGGTAGTAATATG -> GAATTGTGTTGGGTAGTAATATGT
GACACTTACGAGCTGCTCCGATCA -> ACACTTACGAGCTGCTCCGATCAA
ACACTGGAGAACCAAGCGGAGAAT -> CACTGGAGAACCAAGCGGAGAATT
TGACAGCAAGACTGGGACGACTAG -> GACAGCAAGACTGGGACGACTAGT
AGTTGCGAGGACAGGAATCTCGGA -> GTTGCGAGGACAGGAATCTCGGAT
CTAGGAGTCCCACGTGGGTCAATG -> TAGGAGTCCCACGTGGGTCAATGG
AAAACCTACGTATGGCTTGAGTTG -> AAACCTACGTATGGCTTGAGTTGA
TTAGAGCATTCCCCAACCTCAAGC -> TAGAGCATTCCCCAACCTCAAGCA
GACGACTAGTAAACTCGTTGCACA -> ACGACTAGTAAACTCGTTGCACAA
TACGAGCTGCTCCGATCAATAACT -> ACGAGCTGCTCCGATCAATAACTG
CAAGCCCCAGCGCCGAGGTGCCTC -> AAGCCCCAGCGCCGAGGTGCCTCA
CTTATCCGCCGATCGGGATCCACG -> TTATCCGCCGATCGGGATCCACGC
CGAGCTGCTCCGATCAATAACTGA -> GAGCTGCTCCGATCAATAACTGAT
ATCTTATACCAACAGTGTACCAAA -> TCTTATACCAACAGTGTACCAAAG
CCGTGATTAGAAAAGGCGCTCGGT -> CGTGATTAGAAAAGGCGCTCGGTC
CCGAGGAGCTTTGCATCTTATACC -> CGAGGAGCTTTGCATCTTATACCA
TTTACGGATTCTCTACAAACGGGG -> TTACGGATTCTCTACAAACGGGGT
GATGGTAAGTTAAGTCCGAGGAGC -> ATGGTAAGTTAAGTCCGAGGAGCT
TTTAATTGCGCACGTAAAATTTCC -> TTAATTGCGCACGTAAAATTTCCG
CAACACTGATTCCTGGTCTCGGCA -> AACACTGATTCCTGGTCTCGGCAT
TCTCGGATCCCTAGATTCCATAGC -> CTCGGATCCCTAGATTCCATAGCG
GTAGGAGCTTTTAGTACCGAGTTC -> TAGGAGCTTTTAGTACCGAGTTCG
TTCGGTAAGCAATTGCCATGCCTC -> TCGGTAAGCAATTGCCATGCCTCG
ATCCCTAGATTCCATAGCGAGCCT -> TCCCTAGATTCCATAGCGAGCCTA
TTGCGCACGTAAAATTTCCGAGCT -> TGCGCACGTAAAATTTCCGAGCTT
GCAAAGCTTACAATGCAGCCAAGC -> CAAAGCTTACAATGCAGCCAAGCT
AGCGAGCCTATATTAGGCGCTCCT -> GCGAGCCTATATTAGGCGCTCCTA
TGGGCATCAAGTAGAGCAAATACC -> GGGCATCAAGTAGAGCAAATACCC
TCTATAGTTATTCCGTAGTCTTTA -> CTATAGTTATTCCGTAGTCTTTAT
CCGGGCGCGATGGCCGGACATAGA -> CGGGCGCGATGGCCGGACATAGAG
GAACTCCGGTAAAGCAATCCGGCT -> AACTCCGGTAAAGCAATCCGGCTC
AGAGGAACTCCGGTAAAGCAATCC -> GAGGAACTCCGGTAAAGCAATCCG
TAATACTTAACCTTCTCTCCGCTG -> AATACTTAACCTTCTCTCCGCTGA
GTTTGACAGGCGCCTTGATAATGC -> TTTGACAGGCGCCTTGATAATGCG
TCGTTTGCTAAACTACCTTAATAT -> CGTTTGCTAAACTACCTTAATATA
ACTAGTTCCTCCCAACTTGACAGC -> CTAGTTCCTCCCAACTTGACAGCA
GTCCAGTCCCGCGAGTTAATTTTG -> TCCAGTCCCGCGAGTTAATTTTGG
CGATCGGGATCCACGCCGTGTATA -> GATCGGGATCCACGCCGTGTATAT
CTGGTCTCGGCATTGTGCCACCAT -> TGGTCTCGGCATTGTGCCACCATG
ATCCACTTGCCCAACGGCTTACCT -> TCCACTTGCCCAACGGCTTACCTA
TGGACCAGTGCTAGTTCAGAATTC -> GGACCAGTGCTAGTTCAGAATTCT
AGCACGTCCGGTAAGTACTTGACG -> GCACGTCCGGTAAGTACTTGACGT
CGGTAAGCAATTGCCATGCCTCGT -> GGTAAGCAATTGCCATGCCTCGTG
ATGCGAAGGATCTCACGTGAACAT -> TGCGAAGGATCTCACGTGAACATT
CAAACGGGGTTTAGTTTACAGTGA -> AAACGGGGTTTAGTTTACAGTGAT
GGGCATCAAGTAGAGCAAATACCC -> GGCATCAAGTAGAGCAAATACCCG
TACACCGGTAAAAGATGAATAGCC -> ACACCGGTAAAAGATGAATAGCCA
CTAAAACGACCTAGAGGAACTCCG -> TAAAACGACCTAGAGGAACTCCGG
GAAGCTCTTGACGTTTCACCACAC -> AAGCTCTTGACGTTTCACCACACG
AACTCGTTGCACAACTACACTAGG -> ACTCGTTGCACAACTACACTAGGG
ATGAATAGCCAAGGATGCGAAGGA -> TGAATAGCCAAGGATGCGAAGGAT
CGAGGACAGGAATCTCGGATCCCT -> GAGGACAGGAATCTCGGATCCCTA
GTCAATTATGAAGCTCTTGACGTT -> TCAATTATGAAGCTCTTGACGTTT
GCTAGTGATGGTTGTTAGAGCATT -> CTAGTGATGGTTGTTAGAGCATTC
CAGCAAGACTGGGACGACTAGTAA -> AGCAAGACTGGGACGACTAGTAAA
CGATTTCCACCAGTTGCGAGGACA -> GATTTCCACCAGTTGCGAGGACAG
GGAGCCAAGTCATAAATCCGCCTG -> GAGCCAAGTCATAAATCCGCCTGA
AGCCCCAGCGCCGAGGTGCCTCAC -> GCCCCAGCGCCGAGGTGCCTCACT
ATGAGTAGTGTTCGTGCAGGTGTT -> TGAGTAGTGTTCGTGCAGGTGTTT
GTGCGCATTACAGGTGGAGCGTCT -> TGCGCATTACAGGTGGAGCGTCTA
GGTCCGGGCTGGAAGTGTCGGCCG -> GTCCGGGCTGGAAGTGTCGGCCGT
CTTCTCTCCGCTGAGCGCGTAGGA -> TTCTCTCCGCTGAGCGCGTAGGAG
CCTTAATGCATGGCTCGCACGACA -> CTTAATGCATGGCTCGCACGACAC
TTGTGTTGGGTAGTAATATGTTCG -> TGTGTTGGGTAGTAATATGTTCGT
GGCGCGTGTCCAAAAGGTGTTCAG -> GCGCGTGTCCAAAAGGTGTTCAGC
ATTTTACGGATTCTCTACAAACGG -> TTTTACGGATTCTCTACAAACGGG
TGGCCGTATTGGTATAAAGATCCC -> GGCCGTATTGGTATAAAGATCCCC
GGGACGACTAGTAAACTCGTTGCA -> GGACGACTAGTAAACTCGTTGCAC
GTTGTTAGAGCATTCCCCAACCTC -> TTGTTAGAGCATTCCCCAACCTCA
TGTTCAGCGATTCCATCGGACGGT -> GTTCAGCGATTCCATCGGACGGTG
CTTGACGTTTCACCACACGTCCCC -> TTGACGTTTCACCACACGTCCCCG
CGTGATTAGAAAAGGCGCTCGGTC -> GTGATTAGAAAAGGCGCTCGGTCA
CTAGTAAACTCGTTGCACAACTAC -> TAGTAAACTCGTTGCACAACTACA
CTCTGGCGGGGCCACACAATGGAC -> TCTGGCGGGGCCACACAATGGACC
AAAATTTCCGAGCTTTGCTGGCCT -> AAATTTCCGAGCTTTGCTGGCCTT
GATCCACGCCGTGTATATAAAGAT -> ATCCACGCCGTGTATATAAAGATA
GCCGATCGGGATCCACGCCGTGTA -> CCGATCGGGATCCACGCCGTGTAT
AGTAAACTCGTTGCACAACTACAC -> GTAAACTCGTTGCACAACTACACT
TGCTAAACTACCTTAATATAAGAT -> GCTAAACTACCTTAATATAAGATC
GGCTGTGTAAAGTTTGACAGGCGC -> GCTGTGTAAAGTTTGACAGGCGCC
AATTTCATGTTATCCACTTGCCCA -> ATTTCATGTTATCCACTTGCCCAA
CGACTTAAGGTTCTGCTGTCGGGG -> GACTTAAGGTTCTGCTGTCGGGGG
CAAGACTGGGACGACTAGTAAACT -> AAGACTGGGACGACTAGTAAACTC
GATCCCTAGATTCCATAGCGAGCC -> ATCCCTAGATTCCATAGCGAGCCT
TAGGAGTCCCACGTGGGTCAATGG -> AGGAGTCCCACGTGGGTCAATGGC
ATCTCACGTGAACATTGTCTAATT -> TCTCACGTGAACATTGTCTAATTG
GCGAAGGATCTCACGTGAACATTG -> CGAAGGATCTCACGTGAACATTGT
ATTCCTGGTCTCGGCATTGTGCCA -> TTCCTGGTCTCGGCATTGTGCCAC
CGTTCCGATATGGAACAAACTGGT -> GTTCCGATATGGAACAAACTGGTC
CCCCCCTATACGAGACGCTCAGCG -> CCCCCTATACGAGACGCTCAGCGA
ATGCCTCGTGCAAAGCTTACAATG -> TGCCTCGTGCAAAGCTTACAATGC
GCCAACTAGGGCGAAATCGTCTCT -> CCAACTAGGGCGAAATCGTCTCTT
GTCTCTTTTCGTCGTATGAGTAGT -> TCTCTTTTCGTCGTATGAGTAGTG
ATAGCAATTTCATGTTATCCACTT -> TAGCAATTTCATGTTATCCACTTG
TTTTAGTACCGAGTTCGGTAAGCA -> TTTAGTACCGAGTTCGGTAAGCAA
GATTCTCTACAAACGGGGTTTAGT -> ATTCTCTACAAACGGGGTTTAGTT
TACTGCTGGCGAACCCTAGTAGGC -> ACTGCTGGCGAACCCTAGTAGGCT
ACATTGGTCCGGCTGTACTCTGGC -> CATTGGTCCGGCTGTACTCTGGCG
CCCGCGAGTTAATTTTGGGCATCA -> CCGCGAGTTAATTTTGGGCATCAA
TGTATATAAAGATATGTCGTTTGC -> GTATATAAAGATATGTCGTTTGCT
AGCAATTTCATGTTATCCACTTGC -> GCAATTTCATGTTATCCACTTGCC
ATGCATGGCTCGCACGACACTTAC -> TGCATGGCTCGCACGACACTTACG
GCTAACATGAACGCGACGCTATAC -> CTAACATGAACGCGACGCTATACT
TGGTCCGGCTGTACTCTGGCGGGG -> GGTCCGGCTGTACTCTGGCGGGGC
CTAATGGCCAACTAGGGCGAAATC -> TAATGGCCAACTAGGGCGAAATCG
AGATCGAGGCTTAGTCCACGACCT -> GATCGAGGCTTAGTCCACGACCTA
GTGTATATAAAGATATGTCGTTTG -> TGTATATAAAGATATGTCGTTTGC
AAGGTGTTCAGCGATTCCATCGGA -> AGGTGTTCAGCGATTCCATCGGAC
GCCTCACTTAACGGGGAATGCAGG -> CCTCACTTAACGGGGAATGCAGGA
CTCGGATCCCTAGATTCCATAGCG -> TCGGATCCCTAGATTCCATAGCGA
TGACAGGCGCCTTGATAATGCGAC -> GACAGGCGCCTTGATAATGCGACT
GCGAGCGGCCAACCTATCCTTTAA -> CGAGCGGCCAACCTATCCTTTAAA
CACCGGTAAAAGATGAATAGCCAA -> ACCGGTAAAAGATGAATAGCCAAG
AATGGACCAGTGCTAGTTCAGAAT -> ATGGACCAGTGCTAGTTCAGAATT
CAACCTATCCTTTAAAGGATCAAG -> AACCTATCCTTTAAAGGATCAAGC
AACACTGATTCCTGGTCTCGGCAT -> ACACTGATTCCTGGTCTCGGCATT
TGCGAGGACAGGAATCTCGGATCC -> GCGAGGACAGGAATCTCGGATCCC
AACACTGGAGAACCAAGCGGAGAA -> ACACTGGAGAACCAAGCGGAGAAT
TCCGGGCTGGAAGTGTCGGCCGTG -> CCGGGCTGGAAGTGTCGGCCGTGA
CCAGCGCCGAGGTGCCTCACTTAA -> CAGCGCCGAGGTGCCTCACTTAAC
CTATTTTACGCATGCGAGACATTA -> TATTTTACGCATGCGAGACATTAG
GGGAGCCAAGTCATAAATCCGCCT -> GGAGCCAAGTCATAAATCCGCCTG
GCACGTAAAATTTCCGAGCTTTGC -> CACGTAAAATTTCCGAGCTTTGCT
TAGATTCCATAGCGAGCCTATATT -> AGATTCCATAGCGAGCCTATATTA
GTCGTATGAGTAGTGTTCGTGCAG -> TCGTATGAGTAGTGTTCGTGCAGG
TGCCTCACTTAACGGGGAATGCAG -> GCCTCACTTAACGGGGAATGCAGG
CTTGCCCAACGGCTTACCTAGGAG -> TTGCCCAACGGCTTACCTAGGAGT
CTCGTGCAAAGCTTACAATGCAGC -> TCGTGCAAAGCTTACAATGCAGCC
TTCGCTAGTTTCCGCGGTACGACT -> TCGCTAGTTTCCGCGGTACGACTT
CCGGTAAAAGATGAATAGCCAAGG -> CGGTAAAAGATGAATAGCCAAGGA
TAGTTCAGAATTCTTGCAGTGGAA -> AGTTCAGAATTCTTGCAGTGGAAC
CGGATTCTCTACAAACGGGGTTTA -> GGATTCTCTACAAACGGGGTTTAG
TGTGTAAAGTTTGACAGGCGCCTT -> GTGTAAAGTTTGACAGGCGCCTTG
CACTTAACGGGGAATGCAGGAGGA -> ACTTAACGGGGAATGCAGGAGGAA
TGAGTTGAGTAGGCCCAATGCGGC -> GAGTTGAGTAGGCCCAATGCGGCC
ACGATGTTCATAATTTCTTACGAC -> CGATGTTCATAATTTCTTACGACT
AACCAAGCGGAGAATTAAGTAATG -> ACCAAGCGGAGAATTAAGTAATGA
CCAAAGGCATACTGCTGGCGAACC -> CAAAGGCATACTGCTGGCGAACCC
GTTAGTGCGCATTACAGGTGGAGC -> TTAGTGCGCATTACAGGTGGAGCG
GAACGCGACGCTATACTTGATACA -> AACGCGACGCTATACTTGATACAA
GAAGCTAGTGATGGTTGTTAGAGC -> AAGCTAGTGATGGTTGTTAGAGCA
GTCCACGACCTAATACTTAACCTT -> TCCACGACCTAATACTTAACCTTC
TTAAGTCCGAGGAGCTTTGCATCT -> TAAGTCCGAGGAGCTTTGCATCTT
ACCTAGAGGAACTCCGGTAAAGCA -> CCTAGAGGAACTCCGGTAAAGCAA
TTATGAAGCTCTTGACGTTTCACC -> TATGAAGCTCTTGACGTTTCACCA
ACTGATTCCTGGTCTCGGCATTGT -> CTGATTCCTGGTCTCGGCATTGTG
AAAGGCATACTGCTGGCGAACCCT -> AAGGCATACTGCTGGCGAACCCTA
GGTGCCTCACTTAACGGGGAATGC -> GTGCCTCACTTAACGGGGAATGCA
CGGTACGACTTGTGAATGCAAAAG -> GGTACGACTTGTGAATGCAAAAGC
CAGTCCCGCGAGTTAATTTTGGGC -> AGTCCCGCGAGTTAATTTTGGGCA
ATTAGGCGCTCCTAATGGCCAACT -> TTAGGCGCTCCTAATGGCCAACTA
TAAAGTGGCCGTATTGGTATAAAG -> AAAGTGGCCGTATTGGTATAAAGA
ACTTAAGGTTCTGCTGTCGGGGGT -> CTTAAGGTTCTGCTGTCGGGGGTT
CACAACTACACTAGGGCTGACGCT -> ACAACTACACTAGGGCTGACGCTC
CGTATGGCTTGAGTTGAGTAGGCC -> GTATGGCTTGAGTTGAGTAGGCCC
CAACTAGGGCGAAATCGTCTCTTT -> AACTAGGGCGAAATCGTCTCTTTT
ATTTCATGTTATCCACTTGCCCAA -> TTTCATGTTATCCACTTGCCCAAC
TTGTAGGGGTGCATAGACGGCTGT -> TGTAGGGGTGCATAGACGGCTGTG
AAAGGCGCTCGGTCATTACTAGAA -> AAGGCGCTCGGTCATTACTAGAAT
CTTACGAGCTGCTCCGATCAATAA -> TTACGAGCTGCTCCGATCAATAAC
GTATCGATTTCCACCAGTTGCGAG -> TATCGATTTCCACCAGTTGCGAGG
ATTTTACGCATGCGAGACATTAGC -> TTTTACGCATGCGAGACATTAGCT
GTGATTATAGGCAGGTTAGTGCGC -> TGATTATAGGCAGGTTAGTGCGCA
AAGTACTTGACGTTTCCGTACTCA -> AGTACTTGACGTTTCCGTACTCAC
TTCCGAGCTTTGCTGGCCTTCGCT -> TCCGAGCTTTGCTGGCCTTCGCTA
AATCAACACTGATTCCTGGTCTCG -> ATCAACACTGATTCCTGGTCTCGG
TGGTCGAAGTCCAGTCCCGCGAGT -> GGTCGAAGTCCAGTCCCGCGAGTT
GCTTTTCATTAGGAAACTCACAGC -> CTTTTCATTAGGAAACTCACAGCT
AGATGAATAGCCAAGGATGCGAAG -> GATGAATAGCCAAGGATGCGAAGG
CAACAGTGTACCAAAGGCATACTG -> AACAGTGTACCAAAGGCATACTGC
TAGGCAGGTTAGTGCGCATTACAG -> AGGCAGGTTAGTGCGCATTACAGG
CCGATCAATAACTGATCTCTGTAC -> CGATCAATAACTGATCTCTGTACA
GCGTAGGAGCTTTTAGTACCGAGT -> CGTAGGAGCTTTTAGTACCGAGTT
TCTTGCAGTGGAACTATTTTACGC -> CTTGCAGTGGAACTATTTTACGCA
CCTAATGGCCAACTAGGGCGAAAT -> CTAATGGCCAACTAGGGCGAAATC
CTCACGTGGTCTTTTAATTGCGCA -> TCACGTGGTCTTTTAATTGCGCAC
TGCTGGCGAACCCTAGTAGGCTCT -> GCTGGCGAACCCTAGTAGGCTCTT
AGTTAATTTTGGGCATCAAGTAGA -> GTTAATTTTGGGCATCAAGTAGAG
GCTCGTCTATTTTACGGATTCTCT -> CTCGTCTATTTTACGGATTCTCTA
CCGTCGCGGATCCACAGGCCCTGA -> CGTCGCGGATCCACAGGCCCTGAT
AGGGCTGACGCTCGTCTATTTTAC -> GGGCTGACGCTCGTCTATTTTACG
GTAGTAATATGTTCGTAAAATAGC -> TAGTAATATGTTCGTAAAATAGCC
CCTCCAAATTTACATTGGTCCGGC -> CTCCAAATTTACATTGGTCCGGCT
GTTCAGAATTCTTGCAGTGGAACT -> TTCAGAATTCTTGCAGTGGAACTA
CTTGCAGTGGAACTATTTTACGCA -> TTGCAGTGGAACTATTTTACGCAT
ACGTTTCACCACACGTCCCCGACT -> CGTTTCACCACACGTCCCCGACTT
CGGGGAATGCAGGAGGAACGATGT -> GGGGAATGCAGGAGGAACGATGTT
CCAATGCGGCCGCCCTTACGGATG -> CAATGCGGCCGCCCTTACGGATGG
ATTGTGTTGGGTAGTAATATGTTC -> TTGTGTTGGGTAGTAATATGTTCG
CCACCATGCTCCTTGCGAGCGGCC -> CACCATGCTCCTTGCGAGCGGCCA
AATGCGGCCGCCCTTACGGATGGT -> ATGCGGCCGCCCTTACGGATGGTC
GCTCAGCGATGGTAAGTTAAGTCC -> CTCAGCGATGGTAAGTTAAGTCCG
AATCGTCTCTTTTCGTCGTATGAG -> ATCGTCTCTTTTCGTCGTATGAGT
AGGTTCTGCTGTCGGGGGTTGTAG -> GGTTCTGCTGTCGGGGGTTGTAGG
GGCCACACAATGGACCAGTGCTAG -> GCCACACAATGGACCAGTGCTAGT
TAGTAATATGTTCGTAAAATAGCC -> AGTAATATGTTCGTAAAATAGCCG
ACGACTAGTAAACTCGTTGCACAA -> CGACTAGTAAACTCGTTGCACAAC
AGTCCCGCGAGTTAATTTTGGGCA -> GTCCCGCGAGTTAATTTTGGGCAT
TGCTCCGATCAATAACTGATCTCT -> GCTCCGATCAATAACTGATCTCTG
GAACGATGTTCATAATTTCTTACG -> AACGATGTTCATAATTTCTTACGA
GCCTTGATAATGCGACTTACCAAG -> CCTTGATAATGCGACTTACCAAGG
TTCGTCGTATGAGTAGTGTTCGTG -> TCGTCGTATGAGTAGTGTTCGTGC
CAGTGATTATAGGCAGGTTAGTGC -> AGTGATTATAGGCAGGTTAGTGCG
GTTCAGCGATTCCATCGGACGGTG -> TTCAGCGATTCCATCGGACGGTGC
CCAGCTCTATGTATAGCAATTTCA -> CAGCTCTATGTATAGCAATTTCAT
GTTTGCTAAACTACCTTAATATAA -> TTTGCTAAACTACCTTAATATAAG
TTCTCTCCGCTGAGCGCGTAGGAG -> TCTCTCCGCTGAGCGCGTAGGAGC
GCCACCATGCTCCTTGCGAGCGGC -> CCACCATGCTCCTTGCGAGCGGCC
AAGTGGCCGTATTGGTATAAAGAT -> AGTGGCCGTATTGGTATAAAGATC
AGTCCAGTCCCGCGAGTTAATTTT -> GTCCAGTCCCGCGAGTTAATTTTG
AGCAAATACCCGCTTTTCATTAGG -> GCAAATACCCGCTTTTCATTAGGA
AGCCTATATTAGGCGCTCCTAATG -> GCCTATATTAGGCGCTCCTAATGG
TGAAGACGTGGTCCGGGCTGGAAG -> GAAGACGTGGTCCGGGCTGGAAGT
ACGGATGGTCGAAGTCCAGTCCCG -> CGGATGGTCGAAGTCCAGTCCCGC
TCGGCATTGTGCCACCATGCTCCT -> CGGCATTGTGCCACCATGCTCCTT
TTGTGAATGCAAAAGCCATTGGCC -> TGTGAATGCAAAAGCCATTGGCCC
AGATATGTCGTTTGCTAAACTACC -> GATATGTCGTTTGCTAAACTACCT
TCCTGGTCTCGGCATTGTGCCACC -> CCTGGTCTCGGCATTGTGCCACCA
ATACTTGATACAACGCCCCTCACG -> TACTTGATACAACGCCCCTCACGT
TGCAAAGCTTACAATGCAGCCAAG -> GCAAAGCTTACAATGCAGCCAAGC
GCGTCTAAAACGACCTAGAGGAAC -> CGTCTAAAACGACCTAGAGGAACT
GACCTAATACTTAACCTTCTCTCC -> ACCTAATACTTAACCTTCTCTCCG
GCGGATCCACAGGCCCTGATTGAA -> CGGATCCACAGGCCCTGATTGAAG
ACAGGCGCCTTGATAATGCGACTT -> CAGGCGCCTTGATAATGCGACTTA
TCTGGCCTTAATGCATGGCTCGCA -> CTGGCCTTAATGCATGGCTCGCAC
ATAAATCCGCCTGACTTTCTATAG -> TAAATCCGCCTGACTTTCTATAGT
ACGGCTGTGTAAAGTTTGACAGGC -> CGGCTGTGTAAAGTTTGACAGGCG
GCGAAATCGTCTCTTTTCGTCGTA -> CGAAATCGTCTCTTTTCGTCGTAT
GCAGGTGTTTAGGTACACCGGTAA -> CAGGTGTTTAGGTACACCGGTAAA
TATGGAACAAACTGGTCAGTTCTA -> ATGGAACAAACTGGTCAGTTCTAC
ACGGATTCTCTACAAACGGGGTTT -> CGGATTCTCTACAAACGGGGTTTA
TTTTAATTGCGCACGTAAAATTTC -> TTTAATTGCGCACGTAAAATTTCC
GCCCTTACGGATGGTCGAAGTCCA -> CCCTTACGGATGGTCGAAGTCCAG
TAATTTTGGGCATCAAGTAGAGCA -> AATTTTGGGCATCAAGTAGAGCAA
GTAAAGCAATCCGGCTCATCCAGC -> TAAAGCAATCCGGCTCATCCAGCT
GAGCCAAGTCATAAATCCGCCTGA -> AGCCAAGTCATAAATCCGCCTGAC
ATGAAGCTCTTGACGTTTCACCAC -> TGAAGCTCTTGACGTTTCACCACA
TTACGGATTCTCTACAAACGGGGT -> TACGGATTCTCTACAAACGGGGTT
TTGCCTCCAAATTTACATTGGTCC -> TGCCTCCAAATTTACATTGGTCCG
GAGCTTTGCTGGCCTTCGCTAGTT -> AGCTTTGCTGGCCTTCGCTAGTTT
CAATTGCCATGCCTCGTGCAAAGC -> AATTGCCATGCCTCGTGCAAAGCT
GGAGCGTCTAAAACGACCTAGAGG -> GAGCGTCTAAAACGACCTAGAGGA
CTCTTCCGTTCCGATATGGAACAA -> TCTTCCGTTCCGATATGGAACAAA
AAGCTAGTGATGGTTGTTAGAGCA -> AGCTAGTGATGGTTGTTAGAGCAT
TCAAGCCCCAGCGCCGAGGTGCCT -> CAAGCCCCAGCGCCGAGGTGCCTC
TTCCGTACTCACCGCGCCTAAAGT -> TCCGTACTCACCGCGCCTAAAGTG
TTTAAAGGATCAAGCCCCAGCGCC -> TTAAAGGATCAAGCCCCAGCGCCG
ACCAACAGTGTACCAAAGGCATAC -> CCAACAGTGTACCAAAGGCATACT
GAAGTGTCGGCCGTGATTAGAAAA -> AAGTGTCGGCCGTGATTAGAAAAG
GGGTTGTAGGGGTGCATAGACGGC -> GGTTGTAGGGGTGCATAGACGGCT
CCCTAGTAGGCTCTTCCGTTCCGA -> CCTAGTAGGCTCTTCCGTTCCGAT
ACTTGACAGCAAGACTGGGACGAC -> CTTGACAGCAAGACTGGGACGACT
AATGCAAAAGCCATTGGCCCTTGT -> ATGCAAAAGCCATTGGCCCTTGTG
TGCTGTCGGGGGTTGTAGGGGTGC -> GCTGTCGGGGGTTGTAGGGGTGCA
GATCAATAACTGATCTCTGTACAC -> ATCAATAACTGATCTCTGTACACA
TCCGATCAATAACTGATCTCTGTA -> CCGATCAATAACTGATCTCTGTAC
TACTTGATACAACGCCCCTCACGT -> ACTTGATACAACGCCCCTCACGTG
TTTCCGTACTCACCGCGCCTAAAG -> TTCCGTACTCACCGCGCCTAAAGT
TTGCCATGCCTCGTGCAAAGCTTA -> TGCCATGCCTCGTGCAAAGCTTAC
CGACTTACCAAGGCGCGTGTCCAA -> GACTTACCAAGGCGCGTGTCCAAA
TGTTAGAGCATTCCCCAACCTCAA -> GTTAGAGCATTCCCCAACCTCAAG
CCTTATACTTGTATCGCGGGATAT -> CTTATACTTGTATCGCGGGATATA
CCAACCTATCCTTTAAAGGATCAA -> CAACCTATCCTTTAAAGGATCAAG
TTCCGCGGTACGACTTGTGAATGC -> TCCGCGGTACGACTTGTGAATGCA
TTCAGCGATTCCATCGGACGGTGC -> TCAGCGATTCCATCGGACGGTGCG
CGATTCCATCGGACGGTGCGGCTC -> GATTCCATCGGACGGTGCGGCTCT
CGTCCCCGACTTAAGGTTCTGCTG -> GTCCCCGACTTAAGGTTCTGCTGT
GATCTCACGTGAACATTGTCTAAT -> ATCTCACGTGAACATTGTCTAATT
CTCCGGGCGCGATGGCCGGACATA -> TCCGGGCGCGATGGCCGGACATAG
CACTTACGAGCTGCTCCGATCAAT -> ACTTACGAGCTGCTCCGATCAATA
TTCCTGGTCTCGGCATTGTGCCAC -> TCCTGGTCTCGGCATTGTGCCACC
AAAACGACCTAGAGGAACTCCGGT -> AAACGACCTAGAGGAACTCCGGTA
CATGTTATCCACTTGCCCAACGGC -> ATGTTATCCACTTGCCCAACGGCT
GCGATGGCCGGACATAGAGGGGAA -> CGATGGCCGGACATAGAGGGGAAG
GGAGAATTAAGTAATGAATCAACA -> GAGAATTAAGTAATGAATCAACAC
TTAGGTACACCGGTAAAAGATGAA -> TAGGTACACCGGTAAAAGATGAAT
TCCGGCTCATCCAGCTCTATGTAT -> CCGGCTCATCCAGCTCTATGTATA
GCAGCACGTCCGGTAAGTACTTGA -> CAGCACGTCCGGTAAGTACTTGAC
CACCGCGCCTAAAGTGGCCGTATT -> ACCGCGCCTAAAGTGGCCGTATTG
TGGTATAAAGATCCCCCCTATACG -> GGTATAAAGATCCCCCCTATACGA
GGCTGACGCTCGTCTATTTTACGG -> GCTGACGCTCGTCTATTTTACGGA
TTGCTGGCCTTCGCTAGTTTCCGC -> TGCTGGCCTTCGCTAGTTTCCGCG
GATTCCATAGCGAGCCTATATTAG -> ATTCCATAGCGAGCCTATATTAGG
TAATTGCCTCCAAATTTACATTGG -> AATTGCCTCCAAATTTACATTGGT
CCTCGTGCAAAGCTTACAATGCAG -> CTCGTGCAAAGCTTACAATGCAGC
TTCCCCAACCTCAAGCATAGAGTA -> TCCCCAACCTCAAGCATAGAGTAT
ACCTCAAGCATAGAGTATCGATTT -> CCTCAAGCATAGAGTATCGATTTC
CCCAACCTCAAGCATAGAGTATCG -> CCAACCTCAAGCATAGAGTATCGA
TGCGAAGGATCTCACGTGAACATT -> GCGAAGGATCTCACGTGAACATTG
GAATACGTCAATTATGAAGCTCTT -> AATACGTCAATTATGAAGCTCTTG
ACCGAGTTCGGTAAGCAATTGCCA -> CCGAGTTCGGTAAGCAATTGCCAT
CCCGCTTTTCATTAGGAAACTCAC -> CCGCTTTTCATTAGGAAACTCACA
AGTTTGACAGGCGCCTTGATAATG -> GTTTGACAGGCGCCTTGATAATGC
TGGCGGGGCCACACAATGGACCAG -> GGCGGGGCCACACAATGGACCAGT
TACACTAGGGCTGACGCTCGTCTA -> ACACTAGGGCTGACGCTCGTCTAT
GCCAAGTCATAAATCCGCCTGACT -> CCAAGTCATAAATCCGCCTGACTT
GAGTCCCACGTGGGTCAATGGCTC -> AGTCCCACGTGGGTCAATGGCTCT
GCTGAATTGTGTTGGGTAGTAATA -> CTGAATTGTGTTGGGTAGTAATAT
GCCTATATTAGGCGCTCCTAATGG -> CCTATATTAGGCGCTCCTAATGGC
TTGACAGCAAGACTGGGACGACTA -> TGACAGCAAGACTGGGACGACTAG
TGGCCTTAATGCATGGCTCGCACG -> GGCCTTAATGCATGGCTCGCACGA
AATGGCCAACTAGGGCGAAATCGT -> ATGGCCAACTAGGGCGAAATCGTC
CCGTACTCACCGCGCCTAAAGTGG -> CGTACTCACCGCGCCTAAAGTGGC
ACTGCTGGCGAACCCTAGTAGGCT -> CTGCTGGCGAACCCTAGTAGGCTC
GCCGTATTGGTATAAAGATCCCCC -> CCGTATTGGTATAAAGATCCCCCC
TAATGCGACTTACCAAGGCGCGTG -> AATGCGACTTACCAAGGCGCGTGT
CTGGAAGTGTCGGCCGTGATTAGA -> TGGAAGTGTCGGCCGTGATTAGAA
TTCCGTTCCGATATGGAACAAACT -> TCCGTTCCGATATGGAACAAACTG
TTCCATCGGACGGTGCGGCTCTGG -> TCCATCGGACGGTGCGGCTCTGGC
TCAATAACTGATCTCTGTACACAT -> CAATAACTGATCTCTGTACACATG
GCGCGATGGCCGGACATAGAGGGG -> CGCGATGGCCGGACATAGAGGGGA
GCCTAAAGTGGCCGTATTGGTATA -> CCTAAAGTGGCCGTATTGGTATAA
CTACACAAAACCTACGTATGGCTT -> TACACAAAACCTACGTATGGCTTG
TCAAGTAGAGCAAATACCCGCTTT -> CAAGTAGAGCAAATACCCGCTTTT
CAGCGATGGTAAGTTAAGTCCGAG -> AGCGATGGTAAGTTAAGTCCGAGG
CAAGCATAGAGTATCGATTTCCAC -> AAGCATAGAGTATCGATTTCCACC
GGTCGAAGTCCAGTCCCGCGAGTT -> GTCGAAGTCCAGTCCCGCGAGTTA
CTGAGCGCGTAGGAGCTTTTAGTA -> TGAGCGCGTAGGAGCTTTTAGTAC
TGGCTCGCACGACACTTACGAGCT -> GGCTCGCACGACACTTACGAGCTG
TTAGTCCACGACCTAATACTTAAC -> TAGTCCACGACCTAATACTTAACC
AGCGGGAGCCAAGTCATAAATCCG -> GCGGGAGCCAAGTCATAAATCCGC
CGGTCATTACTAGAATACGTCAAT -> GGTCATTACTAGAATACGTCAATT
AATATGTTCGTAAAATAGCCGTCG -> ATATGTTCGTAAAATAGCCGTCGC
CTATATTAGGCGCTCCTAATGGCC -> TATATTAGGCGCTCCTAATGGCCA
GTCAATGGCTCTGAGCTTATCCGC -> TCAATGGCTCTGAGCTTATCCGCC
TGTTTAGGTACACCGGTAAAAGAT -> GTTTAGGTACACCGGTAAAAGATG
ATGTTCGTAAAATAGCCGTCGCGG -> TGTTCGTAAAATAGCCGTCGCGGA
GACGCTATACTTGATACAACGCCC -> ACGCTATACTTGATACAACGCCCC
CGCTAGTTTCCGCGGTACGACTTG -> GCTAGTTTCCGCGGTACGACTTGT
GCGCCGAGGTGCCTCACTTAACGG -> CGCCGAGGTGCCTCACTTAACGGG
ATTGCCATGCCTCGTGCAAAGCTT -> TTGCCATGCCTCGTGCAAAGCTTA
GAGCGTCTAAAACGACCTAGAGGA -> AGCGTCTAAAACGACCTAGAGGAA
CAATGCGGCCGCCCTTACGGATGG -> AATGCGGCCGCCCTTACGGATGGT
CCGACTTAAGGTTCTGCTGTCGGG -> CGACTTAAGGTTCTGCTGTCGGGG
CGCCCTTACGGATGGTCGAAGTCC -> GCCCTTACGGATGGTCGAAGTCCA
CTGTACACATGCGAAGCGGGAGCC -> TGTACACATGCGAAGCGGGAGCCA
TCTGGCGGGGCCACACAATGGACC -> CTGGCGGGGCCACACAATGGACCA
TGATTAGAAAAGGCGCTCGGTCAT -> GATTAGAAAAGGCGCTCGGTCATT
CCTCACGTGGTCTTTTAATTGCGC -> CTCACGTGGTCTTTTAATTGCGCA
GCCAAGGATGCGAAGGATCTCACG -> CCAAGGATGCGAAGGATCTCACGT
TTCCGTAGTCTTTATGCAGCACGT -> TCCGTAGTCTTTATGCAGCACGTC
TTAATATAAGATCGAGGCTTAGTC -> TAATATAAGATCGAGGCTTAGTCC
ATGCGAGACATTAGCTGAATTGTG -> TGCGAGACATTAGCTGAATTGTGT
GTCCGGGCTGGAAGTGTCGGCCGT -> TCCGGGCTGGAAGTGTCGGCCGTG
AACCTTCTCTCCGCTGAGCGCGTA -> ACCTTCTCTCCGCTGAGCGCGTAG
TATAAAGATCCCCCCTATACGAGA -> ATAAAGATCCCCCCTATACGAGAC
TTCATTAGGAAACTCACAGCTAAC -> TCATTAGGAAACTCACAGCTAACA
AGTGCGCATTACAGGTGGAGCGTC -> GTGCGCATTACAGGTGGAGCGTCT
GTCCAAAAGGTGTTCAGCGATTCC -> TCCAAAAGGTGTTCAGCGATTCCA
TTTCTATAGTTATTCCGTAGTCTT -> TTCTATAGTTATTCCGTAGTCTTT
CAGGTGTTTAGGTACACCGGTAAA -> AGGTGTTTAGGTACACCGGTAAAA
GACGGCTGTGTAAAGTTTGACAGG -> ACGGCTGTGTAAAGTTTGACAGGC
TATAAACACTGGAGAACCAAGCGG -> ATAAACACTGGAGAACCAAGCGGA
CAGCCAAGCTCGAGAATCTCCGGG -> AGCCAAGCTCGAGAATCTCCGGGC
AATCTCCGGGCGCGATGGCCGGAC -> ATCTCCGGGCGCGATGGCCGGACA
TTTCCGAGCTTTGCTGGCCTTCGC -> TTCCGAGCTTTGCTGGCCTTCGCT
ACGTGGTCTTTTAATTGCGCACGT -> CGTGGTCTTTTAATTGCGCACGTA
GCTCGAGAATCTCCGGGCGCGATG -> CTCGAGAATCTCCGGGCGCGATGG
CCAAGCTCGAGAATCTCCGGGCGC -> CAAGCTCGAGAATCTCCGGGCGCG
CAGGCCCTGATTGAAGACGTGGTC -> AGGCCCTGATTGAAGACGTGGTCC
GTATAAAGATCCCCCCTATACGAG -> TATAAAGATCCCCCCTATACGAGA
CCCCGACTTAAGGTTCTGCTGTCG -> CCCGACTTAAGGTTCTGCTGTCGG
AAGGCGCTCGGTCATTACTAGAAT -> AGGCGCTCGGTCATTACTAGAATA
GACTTGTGAATGCAAAAGCCATTG -> ACTTGTGAATGCAAAAGCCATTGG
TTATCCACTTGCCCAACGGCTTAC -> TATCCACTTGCCCAACGGCTTACC
CATTGGTCCGGCTGTACTCTGGCG -> ATTGGTCCGGCTGTACTCTGGCGG
TGAACGCGACGCTATACTTGATAC -> GAACGCGACGCTATACTTGATACA
GTGTCCAAAAGGTGTTCAGCGATT -> TGTCCAAAAGGTGTTCAGCGATTC
TTACCTAGGAGTCCCACGTGGGTC -> TACCTAGGAGTCCCACGTGGGTCA
TGGGACGACTAGTAAACTCGTTGC -> GGGACGACTAGTAAACTCGTTGCA
TAGGCCCAATGCGGCCGCCCTTAC -> AGGCCCAATGCGGCCGCCCTTACG
GTCTATTTTACGGATTCTCTACAA -> TCTATTTTACGGATTCTCTACAAA
GCCGGACATAGAGGGGAAGCTAGT -> CCGGACATAGAGGGGAAGCTAGTG
CGTACTCACCGCGCCTAAAGTGGC -> GTACTCACCGCGCCTAAAGTGGCC
TCCACAGGCCCTGATTGAAGACGT -> CCACAGGCCCTGATTGAAGACGTG
TGCGGCCGCCCTTACGGATGGTCG -> GCGGCCGCCCTTACGGATGGTCGA
GATTTCCACCAGTTGCGAGGACAG -> ATTTCCACCAGTTGCGAGGACAGG
TGCCCAACGGCTTACCTAGGAGTC -> GCCCAACGGCTTACCTAGGAGTCC
TCCAAATTTACATTGGTCCGGCTG -> CCAAATTTACATTGGTCCGGCTGT
TGACGCTCGTCTATTTTACGGATT -> GACGCTCGTCTATTTTACGGATTC
AACGATGTTCATAATTTCTTACGA -> ACGATGTTCATAATTTCTTACGAC
CTCCAAATTTACATTGGTCCGGCT -> TCCAAATTTACATTGGTCCGGCTG
AGAGTATCGATTTCCACCAGTTGC -> GAGTATCGATTTCCACCAGTTGCG
AGTAATGAATCAACACTGATTCCT -> GTAATGAATCAACACTGATTCCTG
GAACCAAGCGGAGAATTAAGTAAT -> AACCAAGCGGAGAATTAAGTAATG
CTCAGCGATGGTAAGTTAAGTCCG -> TCAGCGATGGTAAGTTAAGTCCGA
CAGGCGCCTTGATAATGCGACTTA -> AGGCGCCTTGATAATGCGACTTAC
TCGAGAATCTCCGGGCGCGATGGC -> CGAGAATCTCCGGGCGCGATGGCC
CTACCTTAATATAAGATCGAGGCT -> TACCTTAATATAAGATCGAGGCTT
ATATAAGATCGAGGCTTAGTCCAC -> TATAAGATCGAGGCTTAGTCCACG
ACGACTAGTTCCTCCCAACTTGAC -> CGACTAGTTCCTCCCAACTTGACA
TAATGGCCAACTAGGGCGAAATCG -> AATGGCCAACTAGGGCGAAATCGT
CACCAGTTGCGAGGACAGGAATCT -> ACCAGTTGCGAGGACAGGAATCTC
AAATTTCCGAGCTTTGCTGGCCTT -> AATTTCCGAGCTTTGCTGGCCTTC
AGCTTTTAGTACCGAGTTCGGTAA -> GCTTTTAGTACCGAGTTCGGTAAG
GCGGCTCTGGCCTTAATGCATGGC -> CGGCTCTGGCCTTAATGCATGGCT
AGGAGCTTTTAGTACCGAGTTCGG -> GGAGCTTTTAGTACCGAGTTCGGT
GTATATAAAGATATGTCGTTTGCT -> TATATAAAGATATGTCGTTTGCTA
CAAGCTCGAGAATCTCCGGGCGCG -> AAGCTCGAGAATCTCCGGGCGCGA
GTTCGTAAAATAGCCGTCGCGGAT -> TTCGTAAAATAGCCGTCGCGGATC
TGGCTCTGAGCTTATCCGCCGATC -> GGCTCTGAGCTTATCCGCCGATCG
GCCCAATGCGGCCGCCCTTACGGA -> CCCAATGCGGCCGCCCTTACGGAT
GGGGTGCATAGACGGCTGTGTAAA -> GGGTGCATAGACGGCTGTGTAAAG
GTTAGAGCATTCCCCAACCTCAAG -> TTAGAGCATTCCCCAACCTCAAGC
AGTGCTAGTTCAGAATTCTTGCAG -> GTGCTAGTTCAGAATTCTTGCAGT
CCGCCTGACTTTCTATAGTTATTC -> CGCCTGACTTTCTATAGTTATTCC
CGGGCTGGAAGTGTCGGCCGTGAT -> GGGCTGGAAGTGTCGGCCGTGATT
AGTGTCGGCCGTGATTAGAAAAGG -> GTGTCGGCCGTGATTAGAAAAGGC
TGTGAATGCAAAAGCCATTGGCCC -> GTGAATGCAAAAGCCATTGGCCCT
TGGCCAACTAGGGCGAAATCGTCT -> GGCCAACTAGGGCGAAATCGTCTC
CGCTATACTTGATACAACGCCCCT -> GCTATACTTGATACAACGCCCCTC
GTTCTGCTGTCGGGGGTTGTAGGG -> TTCTGCTGTCGGGGGTTGTAGGGG
